text,no_of_words,verb,no_of_verbs,pos_query_word,words_before,word_after,query_word,Priortise
Just happened a terrible car crash,6,['happened'],1,6,5,0,crash,1
Our Deeds are the Reason of this #earthquake May ALLAH Forgive us all,14,['are'],1,9,8,5,earthquake,0
"Heard about #earthquake is different cities, stay safe everyone.",12,"['is', 'stay']",2,4,3,8,earthquake,0
"there is a forest fire at spot pond, geese are fleeing across the street, I cannot save them all",22,"['is', 'are', 'fleeing', 'save']",4,5,4,17,fire,1
Forest fire near La Ronge Sask. Canada,8,['fire'],1,2,1,6,fire,1
All residents asked to 'shelter in place' are being notified by officers. No other evacuation or shelter in place orders are expected,24,"['asked', ""'shelter"", 'are', 'being', 'notified', 'are', 'expected']",7,1,0,23,evacuate,1
"13,000 people receive #wildfires evacuation orders in California ",9,['evacuation'],1,1,0,8,fire,1
Just got sent this photo from Ruby #Alaska as smoke from #wildfires pours into a school ,18,"['got', 'sent', 'pours']",3,1,0,17,fire,1
#RockyFire Update => California Hwy. 20 closed in both directions due to Lake County fire - #CAfire #wildfires,23,['closed'],1,18,17,5,fire,1
"#flood #disaster Heavy rain causes flash flooding of streets in Manitou, Colorado Springs areas",17,['causes'],1,9,8,8,flood,1
Typhoon Soudelor kills 28 in China and Taiwan,8,['kills'],1,1,0,7,typhoon,1
We're shaking...It's an earthquake,8,"[""'re"", 'shaking', ""'s""]",3,8,7,0,earthquake,1
There's an emergency evacuation happening now in the building across the street,13,"[""'s"", 'happening']",2,1,0,12,evacuate,1
Three people died from the heat wave so far,9,"['died', 'wave']",2,3,2,6,die,0
Haha South Tampa is getting flooded hah- WAIT A SECOND I LIVE IN SOUTH TAMPA WHAT AM I GONNA DO WHAT AM I GONNA DO FVCK #flooding,30,"['is', 'getting', 'flooded', 'LIVE', 'flooding']",5,30,29,0,flood,1
#raining #flooding #Florida #TampaBay #Tampa 18 or 19 days. I've lost count ,19,"['raining', 'flooding', ""'ve"", 'lost']",4,4,3,15,flood,0
Damage to school bus on 80 in multi car crash #BREAKING ,12,['crash'],1,10,9,2,crash,1
Birmingham Wholesale Market is ablaze BBC News - Fire breaks out at Birmingham's Wholesale Market http://t.co/irWqCEZWEU,19,"['is', 'breaks']",2,5,4,14,ablaze,1
@bbcmtd Wholesale Markets ablaze http://t.co/lHYXEOHY6C,8,['ablaze'],1,5,4,3,ablaze,1
#AFRICANBAZE: Breaking news:Nigeria flag set ablaze in Aba. http://t.co/2nndBGwyEi,16,"['Breaking', 'set']",2,10,9,6,ablaze,0
INEC Office in Abia Set Ablaze - http://t.co/3ImaomknnA,10,['ablaze'],1,1,0,9,ablaze,1
Barbados #Bridgetown JAMAICA ├½Ôûê├è Two cars set ablaze: SANTA CRUZ ├½Ôûê├ï Head of the St Elizabeth Police Superintende...  http://t.co/wDUEaj8Q4J,24,['set'],1,9,8,15,ablaze,1
How the West was burned: Thousands of wildfires ablaze in California alone http://t.co/vl5TBR3wbr,16,"['was', 'burned', 'ablaze']",3,10,9,6,ablaze,0
"Man wife get six years jail for setting ablaze niece
http://t.co/eV1ahOUCZA",13,"['get', 'setting']",2,9,8,4,ablaze,0
Police: Arsonist Deliberately Set Black Church In North Carolina├òÔò®Ablaze http://t.co/pcXarbH9An,13,['ablaze'],1,1,0,12,ablaze,0
#Kurds trampling on Turkmen flag later set it ablaze while others vandalized offices of Turkmen Front in #Diyala http://t.co/4IzFdYC3cg,23,"['trampling', 'set']",2,10,9,13,ablaze,0
TRUCK ABLAZE : R21. VOORTREKKER AVE. OUTSIDE OR TAMBO INTL. CARGO SECTION. http://t.co/8kscqKfKkF,18,['ablaze'],1,1,0,17,ablaze,0
How the West was burned: Thousands of wildfires ablaze in #California alone http://t.co/iCSjGZ9tE1 #climate #energy http://t.co/9FxmN0l0Bd,24,"['was', 'burned', 'ablaze']",3,10,9,14,ablaze,0
@Navista7 Steve these fires out here are something else! California is a tinderbox - and this clown was setting my 'hood ablaze @News24680,26,"['are', 'is', 'was', 'setting']",4,24,23,2,ablaze,1
@nxwestmidlands huge fire at Wholesale markets ablaze http://t.co/rwzbFVNXER,11,['ablaze'],1,8,7,3,ablaze,1
Accident on I-24 W #NashvilleTraffic. Traffic moving 8m slower than usual. https://t.co/0GHk693EgJ,17,['moving'],1,1,0,16,accident,1
Accident center lane blocked in #SantaClara on US-101 NB before Great America Pkwy #BayArea #Traffic http://t.co/pmlOhZuRWR,21,['blocked'],1,1,0,20,accident,1
Accident cleared in #PaTurnpike on PATP EB between PA-18 and Cranberry slow back to #traffic http://t.co/SL0Oqn0Vyr,20,"['cleared', 'slow']",2,1,0,19,accident,1
Reported motor vehicle accident in Curry on Herman Rd near Stephenson involving an overturned vehicle. Please use... http://t.co/YbJezKuRW1,22,"['Reported', 'involving']",2,4,3,18,accident,1
BigRigRadio Live Accident Awareness,4,['accident'],1,1,0,3,accident,0
I-77 Mile Marker 31 South Mooresville  Iredell Vehicle Accident Ramp Closed at 8/6 1:18 PM,15,['Closed'],1,1,0,14,accident,1
@Traffic_SouthE @roadpol_east Accident on A27 near Lewes is it Kingston Roundabout rather than A283,16,"['@', 'is', 'A283']",3,1,0,15,accident,1
Traffic accident N CABRILLO HWY/MAGELLAN AV MIR (08/06/15 11:03:58),11,['accident'],1,2,1,9,accident,1
I-77 Mile Marker 31 to 40 South Mooresville  Iredell Vehicle Accident Congestion at 8/6 1:18 PM,16,['accident'],1,1,0,15,accident,1
the pastor was not in the scene of the accident......who was the owner of the range rover ?,21,"['was', 'was']",2,10,9,11,accident,0
I was in a horrible car accident this past Sunday. I'm finally able to get around. Thank you GOD??,24,"['was', ""'m"", 'get']",3,7,6,17,accident,0
#TruckCrash Overturns On #FortWorth Interstate http://t.co/Rs22LJ4qFp Click here if you've been in a crash&gt;http://t.co/Ld0unIYw4k,25,"[""'ve"", 'been']",2,1,0,24,accident,0
Accident in #Ashville on US 23 SB before SR 752 #traffic http://t.co/hylMo0WgFI,16,['accident'],1,1,0,15,accident,1
On the #M42 northbound between junctions J3 and J3A there are currently delays of 10 mins due to an accident c... http://t.co/LwI3prBa31,26,['are'],1,21,20,5,accident,1
Carolina accident: Motorcyclist Dies in I-540 Crash With Car That Crossed Median: A motorcycle rider traveling... http://t.co/p18lzRlmy6,22,"['Dies', 'Crossed', 'traveling']",3,2,1,20,accident,1
ACCIDENT - HIT AND RUN - COLD at 500 BLOCK OF SE VISTA TER GRESHAM OR [Gresham Police #PG15000044357] 10:35 #pdx911,25,['accident'],1,1,0,24,accident,1
FYI CAD:FYI: ;ACCIDENT PROPERTY DAMAGE;NHS;999 PINER RD/HORNDALE DR,16,['accident'],1,1,0,15,accident,0
RT nAAYf: First accident in years. Turning onto Chandanee Magu from near MMA. Taxi rammed into me while I was halfway turned. Everyone conf├½Ôûê_,28,"['Turning', 'rammed', 'was', 'turned']",4,5,4,23,accident,1
Accident left lane blocked in #Manchester on Rt 293 NB before Eddy Rd stop and go traffic back to NH-3A delay of 4 mins #traffic,27,"['left', 'blocked', 'go']",3,1,0,26,accident,1
;ACCIDENT PROPERTY DAMAGE; PINER RD/HORNDALE DR,8,['accident'],1,1,0,7,accident,0
FYI CAD:FYI: ;ACCIDENT PROPERTY DAMAGE;WPD;1600 S 17TH ST,16,['accident'],1,1,0,15,accident,0
8/6/2015@2:09 PM: TRAFFIC ACCIDENT NO INJURY at 2781 WILLIS FOREMAN RD http://t.co/VCkIT6EDEv,17,['accident'],1,1,0,16,accident,1
Aashiqui Actress Anu Aggarwal On Her Near-Fatal Accident http://t.co/6Otfp31LqW,11,['accident'],1,1,0,10,accident,0
Suffield Alberta Accident https://t.co/bPTmlF4P10,6,['accident'],1,1,0,5,accident,0
9 Mile backup on I-77 South...accident blocking the Right 2 Lanes at Exit 31 Langtree Rd...consider NC 115 or NC 150 to NC 16 as alternate,30,"['blocking', 'consider']",2,8,7,22,accident,1
#BREAKING: there was a deadly motorcycle car accident that happened to #Hagerstown today. I'll have more details at 5 @Your4State. #WHAG,29,"['was', 'happened', 'have']",3,10,9,19,accident,1
only had a car for not even a week and got in a fucking car accident .. Mfs can't fucking drive .,23,"['had', 'got', 'fucking']",3,16,15,7,accident,0
.@NorwayMFA #Bahrain police had previously died in a road accident they were not killed by explosion https://t.co/gFJfgTodad,22,"['had', 'died', 'were', 'killed']",4,13,12,9,accident,0
'When the aftershock happened (Nepal) we were the last int'l team still there; in a way we were 1st responders.' Chief Collins @LACo_FD,31,"['happened', 'were', 'were']",3,3,2,28,aftershock,0
'We are still living in the aftershock of Hiroshima people are still the scars of history.' - Edward Bond http://t.co/engTl5wrGp,24,"['are', 'living', 'are']",3,7,6,17,aftershock,0
Experts in France begin examining airplane debris found on Reunion Island: French air accident experts o... http://t.co/YVVPznZmXg #news,23,"['begin', 'examining', 'found', 'o']",4,15,14,8,accident,0
Strict liability in the context of an airplane accident: Pilot error is a common component of most aviation cr... http://t.co/6CZ3bOhRd4,24,['is'],1,9,8,15,accident,0
Experts in France begin examining airplane debris found on Reunion Island: French air accident experts on Wedn... http://t.co/bKpFpOGySI,22,"['begin', 'examining', 'found']",3,15,14,7,accident,0
When carelessness leads to an aviation accident the victim has the right to seek compensation for damages. http://t.co/eqAG6rz1vO,21,"['leads', 'has', 'seek']",3,7,6,14,accident,0
@AlexAllTimeLow awwww they're on an airplane accident and they're gonna die what a cuties ???? good job!,25,"[""'re"", ""'re"", 'gon', 'die']",4,9,8,16,accident,0
@rewind_music found out about you guys today(regarding the accident on the airplane lol) &amp; became a fan! Sending love &amp; support from Cali~?,33,"['found', 'guys', 'regarding', 'became']",4,12,11,21,accident,0
family members of osama bin laden have died in an airplane accident how ironic ?????? mhmmm gov shit i suspect,25,"['have', 'died', 'suspect']",3,12,11,13,accident,0
Man Goes into Airplane Engine Accident: http://t.co/TYJxrFd3St via @YouTube,13,['Goes'],1,1,0,12,accident,1
Horrible Accident  Man Died In Wings of Airplane (29-07-2015) http://t.co/i7kZtevb2v,14,['accident'],1,1,0,13,accident,1
A girl who died in an airplane accident fifteen years ago,11,['died'],1,8,7,3,accident,0
A Cessna airplane accident in Ocampo Coahuila Mexico on July 29 2015 killed four men including a State of Coahuila government official.,23,"['killed', 'including']",2,4,3,19,accident,1
#Horrible #Accident Man Died In Wings Airplane (29-07-2015) #WatchTheVideo http://t.co/p64xRVgJIk,17,['accident'],1,1,0,16,accident,0
Experts in France begin examining airplane debris found on Reunion Island http://t.co/LsMx2vwr3J French air accident experts on Wednesday├½Ôûê_,20,"['begin', 'examining', 'found']",3,17,16,3,accident,0
Experts in France begin examining airplane debris found on Reunion Island: French air accident experts on Wednesday began examining t...,22,"['begin', 'examining', 'found', 'began', 'examining']",5,15,14,7,accident,0
#KCA #VoteJKT48ID mbataweel: #RIP #BINLADEN Family members who killed in an airplane's accident,19,['killed'],1,19,18,0,accident,0
Mexican airplane accident in Ocampo Coahuila MX on 7/29/25 killed Coahuila government SubSecretariat Francisco Garcia Castells age 42.,19,['killed'],1,3,2,16,accident,1
Experts in France begin examining airplane debris found on Reunion Island: French air accident experts on... http://t.co/TagZbcXFj0 #MLB,23,"['begin', 'examining', 'found']",3,15,14,8,accident,0
Horrible Accident  Man Died In Wings of Airplane├òÔò®(29-07-2015) http://t.co/5ZRKZdhODe,14,['accident'],1,1,0,13,accident,1
"This is unbelievably insane.
#man #airport #airplane #aircraft #aeroplane #runway #accident #freaky├½Ôûê_ https://t.co/cezhq7CzLl",24,['is'],1,19,18,5,accident,0
Horrible Accident |  Man Died In Wings of Airplane├òÔò®(29-07-2015) http://t.co/wq3wJsgPHL,15,['accident'],1,1,0,14,accident,1
Usama bin Ladins family dead in airplane crash. Naturally no accident.,13,['accident'],1,12,11,1,accident,0
Pilot Dies In Plane Crash At Car Festival https://t.co/kQ9aE6AP2B via @YouTube #Crash #Aircraft #Airplane #Pilot #Death #Accident #CarFest,28,['accident'],1,1,0,27,accident,1
Horrible Accident Man Died In Wings of Airplane (29-07-2015) http://t.co/hG8u2kR1Rq,14,['accident'],1,1,0,13,accident,1
Strict liability in the context of an airplane accident - http://t.co/gibyQHhKpk,13,['accident'],1,9,8,4,accident,1
DTN Brazil: Experts in France begin examining airplane debris found on Reunion Island: French air accident exp... http://t.co/M9IG3WQ8Lq,23,"['begin', 'examining', 'found']",3,18,17,5,accident,0
#UPDATE: Picture from the Penn Twp. airplane accident. http://t.co/6JfgDnZRlC,15,['accident'],1,11,10,4,accident,1
"See how a judge ruled in this 2009 accident at #JFK Airport? involving Korean Air?.

http://t.co/Yh1cGlN3rl http://t.co/6F5ShPKjOB",25,"['See', 'ruled', 'involving']",3,9,8,16,accident,0
Experts in France begin examining airplane debris found on Reunion Island: French air accident experts on Wedn... http://t.co/v4SMAESLK5,22,"['begin', 'examining', 'found']",3,15,14,7,accident,0
Horrible Accident Man Died In Wings Of ├½Ôûê┬ñAirplane├½Ôûê├ÿ 29-07-2015. WTF You Can├½Ôûê┬¼t Believe Your EYES ├½Ôûê├è... http://t.co/6fFyLAjWpS,21,['accident'],1,1,0,20,accident,1
"+ Nicole Fletcher one of a victim of crashed airplane few times ago. 

The accident left a little bit trauma for her. Although she's 

+",28,"['left', ""'s""]",2,16,15,12,accident,0
36 years ago today baseball lost one of its greats in an airplane accident. RIP Captain. #Yankees @yankees http://t.co/iNKU28vjJj,25,"['lost', 'Yankees']",2,14,13,11,accident,0
Experts in France begin examining airplane debris found on Reunion Island: French air accident experts on Wedn... http://t.co/miw2i0pQxz,22,"['begin', 'examining', 'found']",3,15,14,7,accident,0
OMG Horrible Accident Man Died in Wings of Airplane. http://t.co/xDxDPrcPnS,13,['accident'],1,1,0,12,accident,1
#BreakingNews Experts in France begin examining airplane debris found on Reunion Island: French air accident e...  http://t.co/3XIcUvlvlJ,22,"['begin', 'examining', 'found']",3,17,16,5,accident,0
"#OMG! I don't believe this. #RIP bro
#AirPlane #Accident #JetEngine #TurboJet #Boing #G90 http://t.co/KXxnSZp6nk",27,"['do', 'believe']",2,1,0,26,accident,0
Experts in France begin examining airplane debris found on Reunion Island: French air accident experts on Wednesday began examining t...,22,"['begin', 'examining', 'found', 'began', 'examining']",5,15,14,7,accident,0
Experts in France begin examining airplane debris found on Reunion Island: French air accident experts on Wedn...  http://t.co/KuBsM16OuD,22,"['begin', 'examining', 'found']",3,15,14,7,accident,0
I had a airplane accident.,6,['had'],1,5,4,1,accident,1
airplane crashes on house in Colombia 12 people die in accident https://t.co/ZhJlfLBHZL,14,['die'],1,11,10,3,accident,1
The shooting or the airplane accident  https://t.co/iECc1JDOub,9,['accident'],1,6,5,3,accident,1
Could a drone cause an airplane accident? Pilots worried about use of drones esp. in close vicinity of airports http://t.co/kz35rGngJF #,25,['worried'],1,7,6,18,accident,0
Early wake up call from my sister begging me to come over &amp; ride w/her in the ambulance to the hospital #RODKiai,25,"['wake', 'begging', 'come', 'ride']",4,20,19,5,ambulance,0
http://t.co/AY6zzcUpnz Twelve feared killed in Pakistani air ambulance helicopter crash http://t.co/sC9dNS41Mc,15,"['feared', 'killed']",2,10,9,5,ambulance,1
Two air ambulances on scene of serious crash between two cars and lorry in ... - http://t.co/9pFEaQeSki http://t.co/fntG70rnkx | #EMSNe├½Ôûê_,25,['ambulance'],1,3,2,22,ambulance,1
Twelve feared killed in Pakistani air ambulance helicopter crash - Reuters http://t.co/mDnUGVuBwN #yugvani,16,"['feared', 'killed', 'http']",3,7,6,9,ambulance,1
Twelve feared killed in Pakistani air ambulance helicopter crash http://t.co/zdsug0UjS7,12,"['feared', 'killed']",2,7,6,5,ambulance,1
Anyone travelling Aberystwyth-Shrewsbury right now there's been an incident. Services at a halt just outside Shrews. Ambulance on scene.,23,"['travelling', ""'s"", 'been']",3,1,0,22,ambulance,1
Twelve feared killed in Pakistani air ambulance helicopter crash http://t.co/Xum8YLcb4Q,12,"['feared', 'killed']",2,7,6,5,ambulance,1
AMBULANCE SPRINTER AUTOMATIC FRONTLINE VEHICLE CHOICE OF 14 LEZ COMPLIANT | eBay http://t.co/7X3PDDbT0Z,15,['eBay'],1,1,0,14,ambulance,0
@20skyhawkmm20 @traplord_29 @FREDOSANTANA300 @LilReese300 it was hella crazy 3 fights an ambulance and a couple mosh pits ??,23,['was'],1,16,15,7,ambulance,0
#news Twelve feared killed in Pakistani air ambulance helicopter crash http://t.co/bFeS5tWBzt #til_now #DNA,18,"['feared', 'killed']",2,9,8,9,ambulance,1
http://t.co/7xGLah10zL Twelve feared killed in Pakistani air ambulance helicopter crash http://t.co/THmblAATzP,15,"['feared', 'killed']",2,10,9,5,ambulance,1
Pakistan air ambulance helicopter crash kills nine http://t.co/8E7rY8eBMf,10,['ambulance'],1,3,2,7,ambulance,1
http://t.co/FCqmKFfflW Twelve feared killed in Pakistani air ambulance helicopter crash http://t.co/vAyaYmbNgu,15,"['feared', 'killed']",2,10,9,5,ambulance,1
Twelve feared killed in Pakistani air ambulance helicopter crash http://t.co/3bRme6Sn4t,12,"['feared', 'killed']",2,7,6,5,ambulance,1
when you don't know which way an ambulance is coming from &lt;&lt;,18,"['do', 'know', 'is', 'coming']",4,9,8,9,ambulance,0
Shot 12 times. Found dead in cuffs after being involved in a car accident. Officers told ambulance not to treat him. https://t.co/MEUDJwaaNg,27,"['Found', 'being', 'involved', 'told', 'treat']",5,19,18,8,ambulance,1
#reuters Twelve feared killed in Pakistani air ambulance helicopter crash http://t.co/ShzPyIQok5,14,"['Twelve', 'feared', 'killed']",3,9,8,5,ambulance,1
http://t.co/pWwpUm6RBj Twelve feared killed in Pakistani air ambulance helicopter crash http://t.co/ySpON4d6Qo,15,"['feared', 'killed']",2,10,9,5,ambulance,1
New Nanotech Device Will Be Able To Target And Destroy Blood Clots http://t.co/MnmyJXQ9go #science,17,"['Be', 'Target']",2,1,0,16,ambulance,0
http://t.co/FueRk0gWui Twelve feared killed in Pakistani air ambulance helicopter crash http://t.co/Mv7GgGlmVc,15,"['feared', 'killed']",2,10,9,5,ambulance,1
http://t.co/X5YEUYLT1X Twelve feared killed in Pakistani air ambulance helicopter crash http://t.co/2UgrMd1z1n,15,"['feared', 'killed']",2,10,9,5,ambulance,1
2 held with heroin in ambulance http://t.co/d9sOwi1G21 http://t.co/OPxmdPIwAu,12,['held'],1,6,5,6,ambulance,0
Twelve feared killed in Pakistani air ambulance helicopter crash http://t.co/TH9YwBbeet #worldNews,14,"['feared', 'killed']",2,7,6,7,ambulance,1
Why should a helicopter ambulance ride to transfer to a hospital 21 miles away cost $29800? http://t.co/7ZqIreY7Te http://t.co/9Qp3PqPwZv,24,"['transfer', 'cost']",2,5,4,19,ambulance,0
Annihilated Abs . ?? http://t.co/1xPw292tJe,8,['Annihilated'],1,1,0,7,annihilated,0
Cop pulls drunk driver to safety SECONDS before his car is hit by train. http://t.co/cTL5xzIHxA├òÔò® http://t.co/1kDOZTD9mv via @ViralSpell,24,"['pulls', 'is', 'hit']",3,1,0,23,annihilated,1
Cop pulls drunk driver to safety SECONDS before his car is hit by train. http://t.co/cSsc8HcsXn├òÔò® http://t.co/jBlGyLCsAy via @ViralSpell,24,"['pulls', 'is', 'hit']",3,1,0,23,annihilated,1
@johnboywest The only 'stage' the drama queen can stand on is a drama stage &amp; certainly never the world stage; he would be annihilated.,30,"['stand', 'is', 'be', 'annihilated']",4,29,28,1,annihilated,0
Cop pulls drunk driver to safety SECONDS before his car is hit by train. http://t.co/tHrhKHOGcU├òÔò® http://t.co/tZSZmF2qxE via @ViralSpell,24,"['pulls', 'is', 'hit']",3,1,0,23,annihilated,1
@violentfeminazi I guess that's ok for Armenians since we've spent most of our history getting annihilated,19,"['guess', ""'s"", ""'ve"", 'spent', 'getting', 'annihilated']",6,19,18,0,annihilated,0
70 years since we annihilated 100000 people instantly and became aware that we have the ability to annihilate the whole of humanity,22,"['annihilated', 'became', 'have', 'annihilate']",4,5,4,17,annihilated,0
"During the 1960s the oryx a symbol of the Arabian Peninsula were annihilated by hunters. 
http://t.co/yangEQBUQW http://t.co/jQ2eH5KGLt",22,"['were', 'annihilated']",2,13,12,9,annihilated,0
@thehill this is 1 example of y the Conservatives annihilated Burton v Wiimington Prkng Auth while Liberals stood by &amp;have done nothing,26,"['is', 'annihilated', 'stood', 'have', 'done']",5,11,10,15,annihilated,0
"Aug 3 1915├½Ôûê├ïKAISERJAEGERS WIPED OUT.; Francis Joseph's Crack Regiment Annihilated on Carso Plateau.
http://t.co/D1sPSwl66H",20,['annihilated'],1,1,0,19,annihilated,0
Ready to get annihilated for the BUCS game,8,"['get', 'annihilated']",2,4,3,4,annihilated,0
@PhilipDuncan @breakfastone People 'annihilated by last nights weather'... Really Philip thought you would have forecast that...,21,"[""'annihilated"", 'have', 'forecast']",3,1,0,20,annihilated,1
They should all die! All of them! Everything annihilated!,12,"['die', 'annihilated']",2,11,10,1,annihilated,0
@TomcatArts thus explaining why you were all annihilated. But the few or in this case you the only survivor evolved and became godlike,25,"['explaining', 'were', 'annihilated', 'evolved', 'became']",5,9,8,16,annihilated,0
Cop pulls drunk driver to safety SECONDS before his car is hit by train. http://t.co/F1BAkpNyn6├òÔò® http://t.co/lZXwoAyE4x via @ViralSpell,24,"['pulls', 'is', 'hit']",3,1,0,23,annihilated,1
"ANNIHILATED IN DAMASCUS: SYRIAN ARMY GRINDS ├½Ôûê┬©ALLOOSH AND HIS GANG INTO THE MANURE PILE
http://t.co/7rakhP3bWm",18,['annihilated'],1,1,0,17,annihilated,1
@rvfriedmann Hell is just a fraction of his belief of total annihilation destruction of USA @LodiSilverado @ritzy_jewels,20,['is'],1,13,12,7,annihilation,0
Please sign &amp; RT to save #SaltRiverWildHorses http://t.co/GB8ispiaRP http://t.co/Bx0l87iNc8,16,['save'],1,1,0,15,annihilation,0
annihilating quarterstaff of annihilation,4,['annihilating'],1,4,3,0,annihilation,0
:StarMade: :Stardate 3: :Planetary Annihilation:: http://t.co/I2hHvIUmTm via @YouTube,18,['annihilation'],1,1,0,17,annihilation,0
U.S National Park Services Tonto National Forest: Stop the Annihilation of the Salt River Wild Horse... https://t.co/sW1sBua3mN via @Change,24,['Stop'],1,1,0,23,annihilation,1
U.S National Park Services Tonto National Forest: Stop the Annihilation of the Salt River Wild Horse... http://t.co/KPQk0C4G0M via @Change,24,['Stop'],1,1,0,23,annihilation,1
@CalFreedomMom @steph93065 not to mention a major contributor to the annihilation of Israel,15,"['steph93065', 'mention']",2,13,12,2,annihilation,0
@willienelson We need help! Horses will die!Please RT &amp; sign petition!Take a stand &amp; be a voice for them! #gilbert23 https://t.co/e8dl1lNCVu,35,"['need', 'help', 'die', 'Take', 'be']",5,1,0,34,annihilation,0
U.S National Park Services Tonto National Forest: Stop the Annihilation of the Salt River Wild Horse... https://t.co/ZhXua8kmae via @Change,24,['Stop'],1,1,0,23,annihilation,0
RT SIGN URGENT Stop the Annihilation of the Salt River Wild Horses!!! #savewildhorses #saltriverhorses https://t.co/8AZjFF8eSi,22,['Horses'],1,1,0,21,annihilation,0
U.S National Park Services Tonto National Forest: Stop the Annihilation of the Salt River Wild Horse... https://t.co/d82wlcP49S via @Change,24,['Stop'],1,1,0,23,annihilation,0
Stop the Annihilation of the Salt River Wild Horses! http://t.co/wVobVVtXKg via @Change,16,"['Stop', 'Horses']",2,1,0,15,annihilation,1
ohH NO FUKURODANI DIDN'T SURVIVE THE APOCALYPSE BOKUTO FEELS HORRIBLE  my poor boy my ppor child,17,['SURVIVE'],1,1,0,16,apocalypse,1
Another hour! It's August 05 2015 at 08:02PM Here's Red Rover Zombie Apocalypse 2014! http://t.co/cf9e6TU3g7 #internetradio #collegeradi├½Ôûê_,25,"[""'s""]",1,1,0,24,apocalypse,0
I know it's a question of interpretation but this is a sign of the apocalypse.  I called it https://t.co/my8q1uWIjn,23,"['know', ""'s"", 'is', 'called']",4,16,15,7,apocalypse,0
"Apocalypse no! Why artists should not go into the #Fukushima exclusion zone 
http://t.co/3zqL0qbLUw
#nuclear #ura",21,['go'],1,1,0,20,apocalypse,0
And so it begins.. day one of the snow apocalypse,10,['begins..'],1,10,9,0,apocalypse,0
Dad bought a DVD that looks like a science doc on the front but I read the back and it's actually about the impending biblical apocalypse,27,"['bought', 'looks', 'read', ""'s""]",4,27,26,0,apocalypse,0
There's a Storm over Cairo in the latest 'X-Men Apocalypse' set photo https://t.co/fS012trUDG via @YahooTV,21,"[""'s""]",1,1,0,20,apocalypse,1
The latest from @BryanSinger reveals #Storm is a queen in #Apocalypse @RuPaul @AlexShipppp http://t.co/oQw8Jx6rTs,21,"['reveals', 'is']",2,1,0,20,apocalypse,0
Shadow boxing the apocalypse,4,['boxing'],1,4,3,0,apocalypse,0
"Short Reading

Apocalypse 21:1023 

In the spirit the angel took me to the top of an enormous high mountain and... http://t.co/v8AfTD9zeZ",24,['took'],1,1,0,23,apocalypse,0
#PBBan (Temporary:300) hyider_ghost2 @'aRmageddon | DO NOT KILL | FLAGS ONLY | Fast XP' for Reason,21,['DO'],1,1,0,20,armageddon,0
Armageddon https://t.co/uCSUDk3q1d,4,['armageddon'],1,1,0,3,armageddon,0
"Vladimir Putin Issues Major Warning But Is It Too Late To Escape Armageddon?
http://t.co/gBxafy1m1C",17,"['Warning', 'Is', 'Escape']",3,1,0,16,armageddon,1
#Turkey invades #Israel - Halfway to #Armageddon http://t.co/xUOh3sJNXF,13,['armageddon'],1,1,0,12,armageddon,1
@Erker Again?? Eep! Thought of you yesterday when I saw that hella scary hail. #armageddon?,22,['saw'],1,21,20,1,armageddon,0
Paul Craig Roberts ├½Ôûê├è Vladimir Putin Issues Major Warning But Is It Too Late To Escape A http://t.co/NVfKzv5FEx #brics #roberts #russia,26,"['Warning', 'Is', 'Escape']",3,1,0,25,armageddon,1
"#MustRead: Vladimir #Putin Issues Major Warning But Is It Too Late To Escape Armageddon? by @PCraigRoberts #US #Rus
http://t.co/5GFhfCIjrF",28,"['Warning', 'Is', 'Escape']",3,1,0,27,armageddon,1
Salvation Army hosts rally to reconnect fathers with children: The Salvation Army is hosting a back to school rally├½Ôûê_ http://t.co/rDjpor3AZg,23,"['hosts', 'reconnect', 'is', 'hosting']",4,1,0,22,army,0
But if you build an army of 100 dogs and their leader is a lion all dogs will fight like a lion.,23,"['build', 'is', 'fight']",3,6,5,17,army,0
VICTORINOX SWISS ARMY DATE WOMEN'S RUBBER MOP WATCH 241487 http://t.co/q6VCJaTfjx http://t.co/m1cpEw7kbh,16,['army'],1,1,0,15,army,0
One Direction Is my pick for http://t.co/q2eBlOKeVE Fan Army #Directioners http://t.co/eNCmhz6y34 x1392,17,['Is'],1,1,0,16,army,0
VICTORINOX SWISS ARMY DATE WOMEN'S RUBBER MOP WATCH 241487 http://t.co/yFy3nkkcoH http://t.co/KNEhVvOHVK,16,['army'],1,1,0,15,army,0
@AP what a violent country get the army involved to help control the killings and bring back peace to the poor people.,24,"['get', 'involved', 'help', 'control', 'bring']",5,9,8,15,army,0
Cheesehead Report - Arson charges filed in Jackson County house fire http://t.co/I3Y1ZWjBzO,14,['filed'],1,1,0,13,arson,1
Arson suspect linked to 30 fires caught in Northern California http://t.co/z8tlcAdKOw,13,"['linked', 'caught']",2,1,0,12,arson,1
Israeli police unable to solve the case of Duma arson attack http://t.co/WtZgXzaf7Z,14,['solve'],1,10,9,4,arson,0
Spokane authorities say they're struggling to solve arson cases like today's on Hamilton. http://t.co/Qbs2k01WzK http://t.co/mvLZIYsGLL,22,"['say', ""'re"", 'struggling', 'solve']",4,9,8,13,arson,0
Thousands attend a rally organized by Peace Now protesting the arson attack that took the life of an http://t.co/bvCKd9pdTi,21,"['attend', 'organized', 'protesting', 'took']",4,11,10,10,arson,1
"SHOCK REPORT: Muslims Setting Wildfires Across American West...Arson Jihad!

http://t.co/92F4nKxjIu",16,['arson'],1,1,0,15,arson,1
#BreakingNews Mourning notices for stabbing arson victims stir ├½Ôûê┬©politics of grief├½Ôûê┬¼ in Israel: Posters f... http://t.co/KTKDrGVHgX #rome,23,"['stabbing', 'stir', 'f']",3,7,6,16,arson,0
Another fake hate crime Lesbians burn their own house down. What else Is new :http://t.co/66oBQmxImb,19,"['burn', 'Is']",2,1,0,18,arson,1
Mourning notices for stabbing arson victims stir ├½Ôûê┬©politics of grief├½Ôûê┬¼ in Israel: Posters for Shira Banki and A... http://t.co/WbCtkGGTY9,23,"['Mourning', 'stabbing', 'stir']",3,5,4,18,arson,0
Los Angeles Times: Arson suspect linked to 30 fires caught in Northern ... - http://t.co/xwMs1AWW8m #NewsInTweets http://t.co/TE2YeRugsi,23,"['suspect', 'linked', 'caught', 'http']",4,1,0,22,arson,0
Arson suspect linked to 30 fires caught in Northern California http://t.co/EJ2GHNAfHY,13,"['linked', 'caught']",2,1,0,12,arson,1
RT Saginaw - Police sketches of 2 'persons of interest' in Saginaw arson http://t.co/a2tZJ07nId http://t.co/LvtP5MHjaG,20,['arson'],1,14,13,6,arson,1
Trial Date Set for Man Charged with Arson Burglary http://t.co/WftCrLz32P,12,['arson'],1,1,0,11,arson,0
"After death of Palestinian toddler in arson
attack Israel cracks down on Jewish",13,['cracks'],1,7,6,6,arson,0
Palestinian Teen Killed Amid Protests Against Arson Attack http://t.co/okVsImoGic,11,['arson'],1,1,0,10,arson,0
#Kisii Police in Kisii hunt for students over failed arson plot: Police in Kisii hunt for students... http://t.co/m5SbFRrSn7 #CountyNews,25,['arson'],1,11,10,14,arson,1
Mariah getting thick in the shoulders poor girl.,9,['getting'],1,1,0,8,arson,0
Fire That Destroyed Charlton Winery Ruled To Be Arson http://t.co/4a9l0jrMYB,12,['Ruled'],1,1,0,11,arson,0
RelaxInPR: miprv: RT latimes: Arson suspect linked to 30 fires caught in Northern California http://t.co/ylhAyfaOOu,20,"['suspect', 'linked', 'caught']",3,1,0,19,arson,0
Jewish leaders prayed at the hospital where a Palestinian family is being treated after arson http://t.co/Wf8iTK2KVx via @HuffPostRelig,21,"['prayed', 'is', 'being', 'treated']",4,15,14,6,arson,1
#Kisii Police in Kisii hunt for students over failed arson plot: Police in Kisii hunt for students... http://t.co/5bdrFU1duo #CountyNews,25,['arson'],1,11,10,14,arson,0
Mourning notices for stabbing arson victims stir ├½Ôûê┬©politics of grief├½Ôûê┬¼ in Israel http://t.co/Q4L7Dg56JM,15,"['Mourning', 'stabbing', 'stir']",3,5,4,10,arson,0
Man charged in connection to Shawnee arson and burglary: OLATHE Kan. ├½Ôûê├ï A man was in court Wednesday accused of├½Ôûê_ http://t.co/zcXmQoKtZ1,24,"['charged', '├½Ôûê├ï', 'was', 'accused']",4,7,6,17,arson,1
Mourning notices for stabbing arson victims stir ├½Ôûê┬©politics of grief├½Ôûê┬¼ in Israel http://t.co/GbluHRrlto,15,"['Mourning', 'stabbing', 'stir']",3,5,4,10,arson,0
Owner of Chicago-Area Gay Bar Admits to Arson Scheme http://t.co/ZPxE3fMYNG #LGBT,14,['arson'],1,1,0,13,arson,0
960KZIM: Steele police arrest 2 in possible arson investigation https://t.co/w6ZbWryqjC,13,['arson'],1,9,8,4,arson,1
Arson suspect linked to 30 fires caught in Northern California http://t.co/wnuqQAtTTP (via @latimes),18,"['linked', 'caught']",2,1,0,17,arson,0
Tennessee lesbian couple faked hate crime and destroyed own home with arson├½Ôûê_ http://t.co/10mUEY8PXJ #Lesbian,17,"['faked', 'destroyed']",2,12,11,5,arson,0
Arson suspect linked to 30 fires caught in Northern California http://t.co/HkFPyNb4PS,13,"['linked', 'caught']",2,1,0,12,arson,0
RT @TheAdvocateMag: Owner of Chicago-Area Gay Bar Admits to Arson Scheme http://t.co/wHTMwtgROJ #p2 #LGBT,20,['arson'],1,1,0,19,arson,0
Arson suspect linked to 30 fires caught in Northern California - Los Angeles Times http://t.co/PrRB4fhXtv,17,"['linked', 'caught']",2,1,0,16,arson,0
#LGBTQ News ?? Owner of Chicago-Area Gay Bar Admits to Arson Scheme: Frank Elliott pleaded... http://t.co/sGb9vNWqUx Via @TheAdvocateMag,25,['pleaded'],1,1,0,24,arson,0
Arson suspect linked to 30 fires caught in Northern California http://t.co/u1fuWrGK5U,13,"['linked', 'caught']",2,1,0,12,arson,0
Mourning notices for stabbing arson victims stir ├½Ôûê┬©politics of grief├½Ôûê┬¼ in Israel: Posters for Shira Banki and A... http://t.co/6o92wDfcLu,23,"['Mourning', 'stabbing', 'stir']",3,5,4,18,arson,0
Contra Costa Co. authorities arrest suspected serial arsonist: Authorities believe that├½Ôûê_ http://t.co/bzCmzM7bi5 | http://t.co/LBQldyKgdp,19,"['arrest', 'suspected', 'believe']",3,8,7,11,arsonist,0
Owner of Chicago-Area Gay Bar Admits to Arson Scheme: Frank Elliott pleaded guilty to hiring an arsonist to to... http://t.co/L82mrYxfNK,24,"['pleaded', 'hiring']",2,18,17,6,arsonist,0
@_301DC @Cloudy_goldrush i hate white people mo,9,"['hate', 'mo']",2,1,0,8,arsonist,0
Alleged East Bay serial arsonist arrested http://t.co/WR48AQTUm7,9,['arrested'],1,5,4,4,arsonist,0
Suspected serial arsonist arrested in Calif. http://t.co/PzotPDGAkI,9,"['Suspected', 'arrested']",2,3,2,6,arsonist,0
Arsonist Sets NYC Vegetarian Restaurant on Fire: Police #NewYork - http://t.co/agn4cL4uSK,15,['arsonist'],1,1,0,14,arsonist,0
Arson suspect linked to 30 fires caught in Northern California http://t.co/mmGsyAHDzb,13,"['linked', 'caught']",2,1,0,12,arsonist,0
Arsonist torches a house himself and his getaway vehicle police say - Surrey Leader http://t.co/q0J5lTVD6k @RichardGEarl,19,"['torches', 'say']",2,1,0,18,arsonist,0
#Arsonist arrested for setting many fires. WATCH tonight├½Ôûê┬¼s other #headlines: http://t.co/sqgogJ3S5r. #Nightbeat @VeronicaDLCruz #2MinuteMix,24,"['arrested', 'setting']",2,1,0,23,arsonist,0
Hotel arsonist who caused ├ò├║70000 damage was ├½Ôûê┬©crying for help├½Ôûê┬¼: An arsonist has been jailed after a court hear... http://t.co/HNGDdBhewa,24,"['caused', 'was', '├½Ôûê┬©crying', 'has', 'been', 'jailed']",6,13,12,11,arsonist,0
suspected serial arsonist in east bay under arrest @christinKPIX5 @NightBeatTV 10pm @KBCWtv @VeronicaDLCruz,17,['suspected'],1,3,2,14,arsonist,1
Alleged East Bay serial arsonist arrested #SanFrancisco - http://t.co/ojuHfkHVb2,12,['arrested'],1,5,4,7,arsonist,1
Suspected serial arsonist arrested in NorCal http://t.co/Dty4t75CGu http://t.co/MjxbygejyL,12,"['Suspected', 'arrested']",2,3,2,9,arsonist,1
Serial arsonist gets no bail not jail release http://t.co/rozs6aumsS,11,['gets'],1,2,1,9,arsonist,0
Big Top Burning The True Story Of An Arsonist A Missing Girl ├½Ôûê_ : http://t.co/QxH1H61cwD .,18,['Burning'],1,1,0,17,arsonist,0
Arson suspect linked to 30 fires caught in Northern California https://t.co/emsXyWp5s5,13,"['linked', 'caught']",2,1,0,12,arsonist,0
Stay vigilent. Civil liberties are under constant attack. #nativehuman #myreligion  https://t.co/WWu070Tjej,17,['are'],1,9,8,8,attack,0
Delhi government to provide free treatment to acid attack victims in private hospitals #AAPatWork http://t.co/xjtp8SBpt3,18,"['provide', 'acid']",2,9,8,9,attack,0
http://t.co/pTKrXtZjtV  Nashville Theater Attack: Will Gun Grabbers Now Demand ├½Ôûê┬ñHatchet Control?├½Ôûê├ÿ,16,['attack'],1,1,0,15,attack,0
"BREAKING: Terror Attack On
Police Post #Udhampur",9,['attack'],1,1,0,8,attack,1
it scares me that there's new versions of nuclear attack warnings like just knowing that governments still prepare for them,21,"['scares', ""'s"", 'knowing', 'prepare']",4,11,10,10,attack,0
ISIL claims suicide bombing at Saudi mosque that killed at least 15 http://t.co/Y8IcF89H6w http://t.co/t9MSnZV1Kb,18,"['bombing', 'killed']",2,1,0,17,attack,1
Horrific attack on wife by muslim in Italy http://t.co/nY3l1oRZQb LiveLeak #News,14,['attack'],1,2,1,12,attack,1
├½Ôûê┬¼93 blasts accused Yeda Yakub dies in Karachi of heart attack http://t.co/mfKqyxd8XG #Mumbai,16,"['accused', 'dies']",2,11,10,5,attack,0
@etribune  US Drone attack kills 4-suspected militants in North Waziristan @AceBreakingNews https://t.co/jB038rdFAK,16,"['etribune', 'kills']",2,5,4,11,attack,1
Suspect in latest theater attack had psychological issues http://t.co/3huhZxliiG,11,['had'],1,5,4,6,attack,0
Militants attack police post in Udhampur; 2 SPOs injured | LiveMint http://t.co/Rptouz2iJs | http://t.co/69mLhfefhr #AllTheNews,21,['injured'],1,2,1,19,attack,1
BREAKING: Obama Officials GAVE Muslim Terrorist the Weapon Used in Texas Attack http://t.co/qi8QDw5dFG,16,['Used'],1,1,0,15,attack,0
Delhi Government to Provide Free Treatment to Acid Attack Victims in Private Hospitals http://t.co/H6PM1W7elL,16,['Provide'],1,1,0,15,attack,0
New post from @darkreading http://t.co/8eIJDXApnp New SMB Relay Attack Steals User Credentials Over Internet,17,['darkreading'],1,1,0,16,attack,0
Israeli forces raid home of alleged car attack suspect http://t.co/3GVUS8NPpy #palestine,14,['raid'],1,8,7,6,attack,1
Suspect in latest US theatre attack had psychological issues http://t.co/TvsvjuAVif http://t.co/npovfR4rGo,15,['had'],1,6,5,9,attack,0
#volleyball Attack II Volleyball Training Machine - Sets Simulation - http://t.co/dCDeCFv934 http://t.co/dWBC1dUvdk,17,['attack'],1,1,0,16,attack,0
Notley's tactful yet very direct response to Harper's attack on Alberta's gov't. Hell YEAH Premier! http://t.co/rzSUlzMOkX #ableg #cdnpoli,27,['attack'],1,11,10,16,attack,0
#People #Tilly the #Confused Cat Overcomes Horrible Attack to Win Hearts http://t.co/QtrsYxFzo3,17,['Win'],1,1,0,16,attack,0
Police: Assailant in latest US movie theatre attack was homeless had psychological issues http://t.co/zdCvlYq6qK,17,"['was', 'had']",2,9,8,8,attack,0
To love you love you love you ...  Massive Attack - Angel (HD) https://t.co/9TW34Gffox vÔòá_a @YouTube,21,"['love', 'love', 'love']",3,1,0,20,attack,0
Suspect in latest US theatre attack had psychological issues http://t.co/OnPnBx0ZEx http://t.co/uM5IcN5Et2,15,['had'],1,6,5,9,attack,0
India shud not give any evidence 2 pak.They will share with terrorists &amp; use for next attack.Share with oth contries https://t.co/qioPbTIUVu,25,"['shud', 'give']",2,19,18,6,attack,0
illegal alien released by Obama/DHS 4 times Charged With Rape &amp; Murder of Santa Maria CA Woman Had Prior Offenses  http://t.co/MqP4hF9GpO,25,"['released', 'Charged']",2,1,0,24,attack,0
Strongly condemn attack on ARY news team in Karachi. A cowardly act against those simply trying to do their job!,22,"['trying', 'do']",2,3,2,19,attack,0
Nashville Theater Attack: Will Gun Grabbers Now Demand ├½Ôûê┬ñHatchet Control?├½Ôûê├ÿ  http://t.co/OyoGII97yH,16,['attack'],1,1,0,15,attack,0
The fact that the atomic bombs were called 'Little Boy' and 'Fat man' says a lot about the mentality that went into the attack.,27,"['were', 'called', 'says', 'went']",4,26,25,1,attack,0
A Dayton-area org tells me it was hit by a cyber attack: http://t.co/7LhKJz0IVO,16,"['was', 'hit']",2,12,11,4,attack,1
[infowars]  Nashville Theater Attack: Will Gun Grabbers Now Demand ├½Ôûê┬ñHatchet Control?├½Ôûê├ÿ http://t.co/n3yJb8TcPm #nwo,21,[']'],1,1,0,20,attack,0
Cop injured in gunfight as militants attack Udhampur police post: Suspected militants attacked a police post i... http://t.co/ERW7FdxnCr,22,"['injured', 'attack', 'attacked']",3,14,13,8,attacked,1
Newcastle: Schoolgirl attacked in Seaton Delaval park by 'pack of animals' led by a former friend http://t.co/4xbrVNib9T #newcastle,23,"['attacked', 'led']",2,4,3,19,attacked,1
Cop injured in gunfight as militants attack Udhampur police post: Suspected militants attacked a police post i... http://t.co/2h0dPMv2Ef,22,"['injured', 'attack', 'attacked']",3,14,13,8,attacked,1
Christian Attacked by Muslims at the Temple Mount after Waving Israeli Flag via Pamela Geller - ... http://t.co/ajMtU7EHy2,20,"['Attacked', 'Waving']",2,1,0,19,attacked,1
Christian Attacked by Muslims at the Temple Mount after Waving Israeli Flag via Pamela Geller - ... http://t.co/OGoyzOlJk5,20,"['Attacked', 'Waving']",2,1,0,19,attacked,1
Tennessee man killed by police attacked family with hatchet: 911├òÔò®call http://t.co/pWiw9q30DT,14,"['killed', 'attacked']",2,6,5,8,attacked,1
Israeli helicopters that attacked civilians in Gaza just completed exercises in Greece.,13,"['attacked', 'completed']",2,4,3,9,attacked,0
Christian Attacked by Muslims at the Temple Mount after Waving Israeli Flag via Pamela Geller - ... http://t.co/5qYcZyWKgG,20,"['Attacked', 'Waving']",2,1,0,19,attacked,0
#PT: The unit attacked by IS was responsible for targeting Muslim Scholars and imprisoning the youth. http://t.co/f4LhfmEhzh,22,"['attacked', 'was', 'targeting', 'imprisoning']",4,6,5,16,attacked,0
Christian Attacked by Muslims at the Temple Mount after Waving Israeli Flag via Pamela Geller - ... http://t.co/zb8vVBiSY4,20,"['Attacked', 'Waving']",2,1,0,19,attacked,0
Telnet attacked from 124.13.172.40 (STREAMYX-HOME-SOUTHERN MY),8,['attacked'],1,2,1,6,attacked,1
Christian Attacked by Muslims at the Temple Mount after Waving Israeli Flag via Pamela Geller - ... http://t.co/wGWiQmICL1,20,"['Attacked', 'Waving']",2,1,0,19,attacked,0
I attacked Robot-lvl 1 and I've earned a total of 16000 free satoshis! http://t.co/2PZcXSkNCg #robotcoingame #Bitcoin #FreeBitcoin,24,"['attacked', ""'ve"", 'earned']",3,2,1,22,attacked,0
Christian Attacked by Muslims at the Temple Mount after Waving Israeli Flag via Pamela Geller - ... http://t.co/NhxSe3RTHX,20,"['Attacked', 'Waving']",2,1,0,19,attacked,0
Christian Attacked by Muslims at the Temple Mount after Waving Israeli Flag via Pamela Geller - ... http://t.co/LHBZHWq4B9,20,"['Attacked', 'Waving']",2,1,0,19,attacked,0
Kelly Osbourne attacked for racist Donald Trump remark about Latinos on The View http://t.co/7nAgdSAdWP,16,['attacked'],1,3,2,13,attacked,0
Christian Attacked by Muslims at the Temple Mount after Waving Israeli Flag via Pamela Geller - ... http://t.co/mXZ7yX8ld1,20,"['Attacked', 'Waving']",2,1,0,19,attacked,0
Christian Attacked by Muslims at the Temple Mount after Waving Israeli Flag via Pamela Geller - ... http://t.co/e4YDbM4Dx6,20,"['Attacked', 'Waving']",2,1,0,19,attacked,0
Christian Attacked by Muslims at the Temple Mount after Waving Israeli Flag via Pamela Geller - ... http://t.co/e4wK8Uri8A,20,"['Attacked', 'Waving']",2,1,0,19,attacked,0
Christian Attacked by Muslims at the Temple Mount after Waving Israeli Flag via Pamela Geller - ... http://t.co/7kxGS7VDFy,20,"['Attacked', 'Waving']",2,1,0,19,attacked,0
Christian Attacked by Muslims at the Temple Mount after Waving Israeli Flag via Pamela Geller - ... http://t.co/1pDJoq4Jc1,20,"['Attacked', 'Waving']",2,1,0,19,attacked,0
I was having such a peaceful happy Twitter experience ...then *AVALANCHE OF IDIOCY*!!!!!! https://t.co/iIR1v39THE,23,"['was', 'having']",2,1,0,22,avalanche,0
'One glance and the avalanche drops. One look and my heartbeat stops.' Oh WALK THE MOON how you get me.. I couldn't have said it better.,31,"['get', 'have', 'said']",3,5,4,26,avalanche,0
PLUS PERFORMANCE CHIP FUEL SAVER CHEVY SILVERADO/AVALANCHE/BLAZER/TAHOE http://t.co/eocKbeOGm0 http://t.co/cvjCidgEZ7,13,['avalanche'],1,1,0,12,avalanche,0
Dorion: Sens looking for consistency from Hoffman #ColoradoAvalanche #Avalanche http://t.co/msK68XoY7T http://t.co/ykWKx0QKtX,18,['looking'],1,1,0,17,avalanche,0
driving the avalanche after having my car for a week is like driving a tank,15,"['driving', 'having', 'is', 'driving']",4,3,2,12,avalanche,1
02 03 04 05 AVALANCHE 1500 REAR AXLE ASSEMBLY 2055271 http://t.co/VxZhZsAlra http://t.co/HmXWRkbLS0,16,['avalanche'],1,1,0,15,avalanche,1
Chiasson Sens can't come to deal #ColoradoAvalanche #Avalanche http://t.co/2bk7laGMa9 http://t.co/bkDGCfsuiQ,17,"['come', 'deal']",2,1,0,16,avalanche,0
Senators have another year to determine Hoffman's v... #ColoradoAvs #NHLAvalanche http://t.co/CIzZOc6f0D http://t.co/PEmYHD3Nfz,20,"['have', 'determine']",2,1,0,19,avalanche,0
Avalanche City - Sunset http://t.co/48h3tLvLXr #nowplay #listen #radio,13,['avalanche'],1,1,0,12,avalanche,0
@90sAngelicMalik listen to wtm avalanche and take a deep breath,11,"['wtm', 'take']",2,6,5,5,avalanche,0
Now there's an avalanche... These men are lunatics #livingontheedge,12,"[""'s"", 'are']",2,5,4,7,avalanche,1
Chevrolet : Avalanche LT 2011 lt used 5.3 l v 8 16 v automatic 4 wd pickup truck premium b├½Ôûê_ http://t.co/OBkY8Pc89H http://t.co/dXIRnTdSrd,26,['used'],1,1,0,25,avalanche,0
STAR WARS POWER OF THE JEDI COLLECTION 1 BATTLE DROID HASBRO - Full read by eBay http://t.co/xFguklrlTf http://t.co/FeGu8hWMc4,22,['battle'],1,1,0,21,battle,0
CIVIL WAR GENERAL BATTLE BULL RUN HERO COLONEL 2nd NEW HAMPSHIRE LETTER SIGNED ! http://t.co/Ot0tFFpBYB http://t.co/zaRBwep9LD,20,['battle'],1,1,0,19,battle,0
Indeed!! I am fully aware of that battle! I support you in that fight!!  https://t.co/MctJnZX4H8,22,"['am', 'support']",2,10,9,12,battle,0
Black Eye 9: A space battle occurred at Star M27329 involving 1 fleets totaling 1236 ships with 7 destroyed,20,"['occurred', 'involving', 'totaling']",3,7,6,13,battle,0
#environment Lone Pine trees growing across the country in remembrance of battle at Gallipoli 100 years ago: T... http://t.co/GJCAAnfCYk,24,"['trees', 'growing']",2,13,12,11,battle,1
A young German stormtrooper engaged in the Battle of the Somme 1916. [800 Ôòá├É 582 ] http://t.co/yxvMifLvc4,21,"['engaged', '[']",2,1,0,20,battle,1
I liked a @YouTube video from @screwattack http://t.co/W5dLLV48cs Knuckles punches into DEATH BATTLE!,18,['liked'],1,1,0,17,battle,0
News: FedEx no longer to transport bioterror germs in wake of anthrax lab mishaps http://t.co/xteZGjfs8A,18,['transport'],1,8,7,10,bioterror,0
FedEx no longer to transport bioterror germs in wake of anthrax lab mishaps #breakingnews,15,['transport'],1,6,5,9,bioterror,0
FedEx no longer to transport bioterror germs in wake of anthrax lab mishaps http://t.co/kA0syAhqVW via @usatoday,19,['transport'],1,6,5,13,bioterror,0
FedEx no longer to transport bioterror germs in wake of anthrax lab mishaps http://t.co/HQsU8LWltH via @usatoday,19,['transport'],1,6,5,13,bioterror,0
Jacksonville Busines FedEx stops shipping potential bioterror pathogens http://t.co/sHzsYmaUSi,11,"['stops', 'shipping', 'pathogens']",3,7,6,4,bioterror,0
.@APHL responds: FedEx no longer to transport bioterror germs in wake of anthrax lab mishaps http://t.co/cGdj3dRso9,21,"['responds', 'transport']",2,11,10,10,bioterror,0
#world FedEx no longer to transport bioterror germs in wake of anthrax lab mishaps  http://t.co/wvExJjRG6E,18,['transport'],1,8,7,10,bioterror,0
#FedEx no longer to transport bioterror germs in wake of anthrax lab mishaps http://t.co/S4SiCMYRmH,17,['transport'],1,7,6,10,bioterror,0
USATODAY: On today's #frontpage: #Bioterror lab faced secret sanctions. #RickPerry doesn't make the cut for FoxNew├½Ôûê_ http://t.co/xFHh2XF9Ga,27,"['faced', 'does', 'make']",3,1,0,26,bioterror,1
FedEx no longer to transport bioterror germs in wake of anthrax lab mishaps http://t.co/4M5UHeyfDo via @USATODAY,19,['transport'],1,6,5,13,bioterror,0
Bioterrorism and Ebola. http://t.co/ORIOVftLK4 RT #STOPIslam #TCOT #CCOT #MakeDCListen #TeaParty,18,['bioterrorism'],1,1,0,17,bioterrorism,0
The largest bioterrorism attack on U.S. soil involved tacos @atlasobscura http://t.co/1n9CRhWmgl,14,['involved'],1,3,2,11,bioterrorism,1
To fight bioterrorism sir.,5,['fight'],1,3,2,2,bioterrorism,1
I liked a @YouTube video http://t.co/XO2ZbPBJB3 FEMA REGION III TARGETED for BIOTERRORISM !!! NASA - JAPAN ROCKET LAUNCH with LITHIUM,25,['liked'],1,1,0,24,bioterrorism,0
#anthrax #bioterrorism CDC To Carry Out Extensive Review of Lab Safety And Pathogen Handling Procedures http://t.co/bCLqpWFDOd,20,['Carry'],1,4,3,16,bioterrorism,0
@CAgov If 90BLKs&amp;8WHTs colluded 2 take WHT F @USAgov AUTH Hostage&amp;2 make her look BLK w/Bioterrorism&amp;use her lgl/org IDis ID still hers?@VP,39,"['colluded', 'make', 'use', 'hers']",4,1,0,38,bioterrorism,0
@DarrellIssa Does that 'great Iran deal' cover bioterrorism? You got cut off terrible of them. Keep up the good work.,25,"['got', 'cut', 'Keep']",3,10,9,15,bioterrorism,0
Is it time to hedge against catastrophic risks such as climate change asteroid impacts or bioterrorism? https://t.co/HQ6WqsgSJX,20,"['Is', 'hedge']",2,16,15,4,bioterrorism,0
A Tale of Two Pox - Body Horrors http://t.co/W2IXT1k0AB #virus #infectiousdiseases #bioterrorism,17,['bioterrorism'],1,17,16,0,bioterrorism,1
@USCOURT If 90BLKs&amp;8WHTs colluded 2 take WHT F @USAgov AUTH Hostage&amp;2 make her look BLK w/Bioterrorism&amp;use her lgl/org IDis ID still hers?,37,"['colluded', 'make', 'use', 'hers']",4,1,0,36,bioterrorism,0
Bioterrorism public health superbug biolabs epidemics biosurveillance outbreaks | Homeland Security News Wire http://t.co/cvhYGwcBZv,16,['|'],1,1,0,15,bioterrorism,0
@O_Magazine satan's daughter shadow warrior in 50ft women aka transgender mode ps nyc is about to fold extra extra center of bioterrorism,24,"['is', 'fold']",2,24,23,0,bioterrorism,0
@DrRichardBesser Yes. I would think not. But since college 88-92 it's been difficult not to think of bioterrorism esp. bc 'dispersed.',28,"['think', ""'s"", 'been', 'think', ""'dispersed""]",5,22,21,6,bioterrorism,0
Volunteers needed to participate in Emergency Preparedness drill simulating a bioterrorism disaster: http://t.co/NWV2RvGHf3 @HVnewsnetwork,18,"['needed', 'participate', 'drill', 'simulating']",4,11,10,7,bioterrorism,0
@MeyerBjoern @thelonevirologi @MackayIM of a major American newspaper running a series on all the alleged bioterrorism research going on 2/n,23,"['running', 'alleged', 'going']",3,19,18,4,bioterrorism,0
CDC has a pretty cool list of all bioterrorism agents :3,11,"['has', ':3']",2,9,8,2,bioterrorism,0
@bbcworld Bioterrorism drones can reach large populated erea.,10,['reach'],1,1,0,9,bioterrorism,0
Government Experts Concerned About Possible Bioterrorism Using GM Organisms: Scientists are concerned that the... http://t.co/SuMe5prO0F,19,"['Concerned', 'are', 'concerned']",3,1,0,18,bioterrorism,0
@StationCDRKelly Any Support Sys 4 @USAgov AUTH taken Hostage by BLK US clergyforced 2 exist younger&amp;grossly disfigured by BIOTERRORISM?@AP,28,"['Any', 'taken', 'clergyforced', 'disfigured']",4,1,0,27,bioterrorism,0
To fight bioterrorism sir.,5,['fight'],1,3,2,2,bioterrorism,0
Anthony Kimery Discusses #BioTerrorism on SyFy Channel's 'Joe Rogan Questions Everything' http://t.co/zckJWAcRCs,17,['bioterrorism'],1,1,0,16,bioterrorism,0
@HarvardU If 90BLKs&amp;8WHTs colluded 2 take WHT F @USAgov AUTH Hostage&amp;2 make her look BLK w/Bioterrorism&amp;use her lgl/org IDis ID still hers?,37,"['colluded', 'make', 'use', 'hers']",4,1,0,36,bioterrorism,0
@APhiABeta1907 w/ugliness due 2 your 'ugly'@AMESocialAction Frat's BIOTERRORISMI'm she who's @FBI ID U $tolewant'g another in my Home.@ABC,32,"[""'m"", ""'s""]",2,1,0,31,bioterrorism,0
Uganda Seen as a Front Line in the Bioterrorism Fight,10,['bioterrorism'],1,1,0,9,bioterrorism,0
Ppl living w/ HIV have been charged with aggravated assault and bioterrorism for things w/ low or no risk of transmission. #HIVIsNotaCrime,24,"['living', 'have', 'been', 'charged', 'w/']",5,12,11,12,bioterrorism,0
@HowardU If 90BLKs&amp;8WHTs colluded 2 take WHT F @USAgov AUTH Hostage&amp;2 make her look BLK w/Bioterrorism&amp;use her lgl/org IDis ID still hers?,37,"['colluded', 'make', 'use', 'hers']",4,1,0,36,bioterrorism,0
@GACourts If 90BLKs&amp;8WHTs colluded 2 take WHT F @USAgov AUTH Hostage&amp;2 make her look BLK w/Bioterrorism&amp;use her lgl/org IDis ID still hers?,37,"['GACourts', 'colluded', 'make', 'use', 'hers']",5,1,0,36,bioterrorism,0
@cspanwj If 90BLKs&amp;8WHTs colluded 2 take WHT F @USAgov AUTH Hostage&amp;2 make her look BLK w/Bioterrorism&amp;use her lgl/org IDis ID still hers?,37,"['colluded', 'make', 'use', 'hers']",4,1,0,36,bioterrorism,0
To fight bioterrorism sir.,5,['fight'],1,3,2,2,bioterrorism,0
The #IranDeal only covers nuclear activity. What are they doing about Bioterrorism? Iran has broken at least 27 other agreements.,24,"['covers', 'are', 'doing', 'has', 'broken']",5,1,0,23,bioterrorism,0
@prsnvns that's good to hear. Mine could be better but I can manage. It's alright you do what you have to. Bioterrorism doesn't wait.,32,"[""'s"", 'hear', 'be', 'manage', ""'s"", 'do', 'have', 'does', 'wait']",9,1,0,31,bioterrorism,0
The Threat | Anthrax | CDC http://t.co/q6oxzq45VE via @CDCgov,12,['bioterrorism'],1,1,0,11,bioterrorism,0
#bioterrorism Authorities allay #glanders fears ahead of Rio Olympic equestrian test event http://t.co/UotPNSQpz5 via @HorsetalkNZ,20,['bioterrorism'],1,2,1,18,bioterrorism,0
Pendleton media office said only fire on base right now is the Horno blaze.,15,"['said', 'is']",2,14,13,1,blaze,0
Love living on my own. I can blaze inside my apt or on the balcony,16,['blaze'],1,9,8,7,blaze,1
Property losses from California wildfire nearly double as week-old blaze rages http://t.co/E0UUsnpsq5,14,"['wildfire', 'http']",2,10,9,4,blaze,1
#breaking Firefighters battling blaze at east Cary condo building http://t.co/mIM8hH2ce6,13,"['breaking', 'battling', 'building']",3,5,4,8,blaze,1
Port Coquitlam fire crews say an electric towel warmer started the four alarm blaze last week that destroyed several businesses.,21,"['say', 'started', 'destroyed']",3,14,13,7,blaze,1
I liked a @YouTube video from @ashens http://t.co/yC9tywuzQm Blaze / Atgames Handheld Mega Drives | Ashens,20,['liked'],1,1,0,19,blaze,0
Property losses from #California wildfire nearly double as week-old blaze rages: The fire├½Ôûê_ http://t.co/MsdizftZ2g,18,['wildfire'],1,11,10,7,blaze,1
Omg i need to go like yesterday ???? https://t.co/3oP6G7ovzO,14,"['need', 'go']",2,1,0,13,blaze,0
Lithgow News: Homeless after blaze near Portland http://t.co/Cht5w3znIK,11,['blaze'],1,6,5,5,blaze,1
Montgomery come for the blazing hot weather...stay for the STDs. Yet another rejected city slogan.,19,['rejected'],1,5,4,14,blazing,0
HAPPENING NOW - FDNY RESCUE 1 BLAZING THRU@AND BLASTING THE AIR HORN├½Ôûê_ https://t.co/bX6cwRt8M7,17,['blazing'],1,1,0,16,blazing,0
Satelite Shot: Series of wildfires in Northern California continue blazing: There are at least five fire compl... http://t.co/BmGuHqY7W4,23,"['continue', 'blazing', 'are']",3,11,10,12,blazing,0
@BlazingRoselia California is hot but not blazing even though there are wildfires going on now. Even the big massive Rocky fire,23,"['is', 'blazing', 'are', 'going']",4,8,7,15,blazing,0
#Nepal: This house near TIA bleeding int├½Ôûê┬¼l airline companies dry. | http://t.co/lI8wi1kuMY,17,"['bleeding', 'dry']",2,8,7,9,bleeding,0
you can stab me in the back but I promise you'll be the one bleeding,16,"['stab', 'promise', 'be']",3,16,15,0,bleeding,0
You cut me open and I keep bleeding. #BleedingLove #LeonaLewis #acapella #singer #canadiansinger├½Ôûê_ https://t.co/51pfEIlPNK,22,"['cut', 'keep', 'bleeding']",3,8,7,14,bleeding,1
I waited 2.5 hours to get a cab my feet are bleeding,12,"['waited', 'get', 'are', 'bleeding']",4,12,11,0,bleeding,1
@imKanoMate [the stabbing did not really affect her but she did get stab wounds and was bleeding Skarlet then pushed him backwards +,25,"['[', 'did', 'affect', 'did', 'get', 'stab', 'was', 'bleeding', 'pushed', '+']",10,19,18,6,bleeding,0
@KatRamsland Yes I'm a bleeding heart liberal.,10,"[""'m""]",1,7,6,3,bleeding,0
@Aichmomanic wraps a cloth on my wound but it's still bleeding 'I'll be ok.' Falls to the ground as if I'm going to die,30,"['wraps', ""'s"", 'bleeding', 'be', 'ok.', ""'m"", 'going', 'die']",8,13,12,17,bleeding,0
@beckyfeigin I defs will when it stops bleeding!,10,"['defs', 'stops', 'bleeding']",3,9,8,1,bleeding,0
@Benjm1 @TourofUtah @B1Grego saw that pileup on TV keep racing even bleeding,15,"['saw', 'racing', 'bleeding']",3,15,14,0,bleeding,0
@BenKin97 @Mili_5499 remember when u were up like 4-0 and blew it in one game? U probs don't because it was before the kings won the cup,31,"['remember', 'were', 'blew', 'do', 'was', 'won']",6,1,0,30,blew up,0
That stadium blew up!!,6,['blew'],1,1,0,5,blew up,1
Did anyone else see that fireball falling to earth? Look like a plane blew up.,17,"['see', 'falling', 'earth', 'blew']",4,1,0,16,blew up,1
Lots of talk of how susceptible NY2 is to shoot blight with or without trama. #WCFGT2015,18,"['is', 'shoot']",2,11,10,7,blight,0
Help fight Northern Corn Leaf Blight with Headline Amp https://t.co/LVoqPgkLI7,12,['fight'],1,1,0,11,blight,0
@todd_calfee so @mattburgener wanted to see that info on blight u got,14,"['wanted', 'see', 'got']",3,12,11,2,blight,0
Stamford tightens blight law: A dilapitated barn sits half-erect on Hickory Road near the int... http://t.co/QP65iO4AvC #stamford #topix,24,"['tightens', 'sits']",2,3,2,21,blight,1
2:20 BLIGHT ?? EVERY DAY,6,['blight'],1,1,0,5,blight,0
"This is the Red Eye crossing the ocean
Peeling potatoes with servile devotion...

#BLIGHT!",17,"['is', 'crossing']",2,1,0,16,blight,0
#Detroit has made progress against blight but too many burned out shells of houses remain.,17,"['has', 'made', 'burned', 'remain']",4,7,6,10,blight,0
The #Palestinian #refugee tragedy is a blight on humanity &amp; should shame every #Israeli for living with it. https://t.co/gAAE0nO5du,27,"['is', 'shame', 'living']",3,9,8,18,blight,0
@Ashayo @MsMiggi Hi Ashayo! I believe there will be VODs on YouTube after the presentation but there is nothing like seeing it live :),28,"['believe', 'be', 'is', 'seeing']",4,1,0,27,blizzard,0
@EddieTrunk Blizzard of Ozz,5,['blizzard'],1,1,0,4,blizzard,0
#Tweet4Taiji is a dolphin worship group based on superstitions! Just take a look at their tweets!,19,"['is', 'based', 'take']",3,1,0,18,blizzard,0
@BubblyCuteOne ?????????? ok ok okayyyyyy Ima act right ....bout to get this blizzard tho,25,"['@', 'get']",2,24,23,1,blizzard,0
I call it a little bit of your blizzard?,10,['call'],1,9,8,1,blizzard,0
people with a #tattoo out there.. Are u allowed to donate blood and receive blood as well or not?,21,"['allowed', 'donate']",2,16,15,5,blood,0
Can't believe more people in their mid 20's don't have high blood pressure. Life is stressful. #DecisionsOnDecisions,23,"['believe', 'do', 'have', 'is']",4,15,14,8,blood,0
Ain't no hoe in my blood,7,['Ai'],1,7,6,0,blood,0
seeing more blood and surgery than a regular GP behind a desk and they say dentists aren't  real doctors .... Ok,23,"['seeing', 'say', 'are', 'Ok']",4,3,2,20,blood,0
Private thirsty night?SAD BLOOD ROCK'N ROLL? #??,14,['blood'],1,1,0,13,blood,0
it wasnt a very big stab but it was a deep stab and theres like blood everwhe,17,"['wasnt', 'was']",2,16,15,1,blood,1
Bloody insomnia again! Grrrr!! #Insomnia,9,['bloody'],1,1,0,8,bloody,1
'I came to kill Indians...for FUN': Video of smirking and remorseless Pakistani killer shows him boasting. http://t.co/FPjLwOXKlg,25,"['came', 'kill', 'smirking', 'shows', 'boasting']",5,1,0,24,bloody,1
White family (supposedly representing America's GREAT values ) gets blown up in a horrible CGI nuclear strike..... LMFAOOOO!!!!!!!!!!!!,34,"['representing', 'gets', 'blown']",3,1,0,33,blown up,1
On #ThisDayInHistory in 1862 Confederate ship blown up by crew. Read More http://t.co/IW7ELSzIfZ via @History,20,"['blown', 'Read']",2,1,0,19,blown up,0
"'If a truckload of soldiers will be blown up nobody panics but when one little lion dies everyone loses their mind'
http://t.co/wjNTaOkdHf",24,"[""'If"", 'be', 'blown', 'dies', 'loses']",5,1,0,23,blown up,0
Deadly suicide bombing hits mosque in Saudi Arabia: A suicide bomber has blown himself up at a mosque in the s... http://t.co/RkvU3xjAzH,26,"['bombing', 'has', 'blown']",3,1,0,25,blown up,1
Even though BSG had been sufficiently hyped up for me in all the years I somehow delayed watching it I was utterly utterly blown away.,26,"['had', 'been', 'hyped', 'somehow', 'watching', 'was', 'blown']",7,1,0,25,blown up,0
@HopefulBatgirl went down I was beaten and blown up. Then next thing I know Ra Al Ghul brought me back to life and I escaped and for a---,32,"['went', 'was', 'beaten', 'blown', 'know', 'brought', 'escaped']",7,1,0,31,blown up,1
@bmrow At first thought it was a blown-up DVD as I'm pretty sure POST MORTEM had been years back.,22,"['thought', 'was', ""'m"", 'had', 'been']",5,1,0,21,blown up,0
"#3682 Nikon D50 6.1 MP Digital SLR Camera Body 2 batteries carry bag and charger http://t.co/TeT9q0kXvl

$200.00
├½Ôûê_ http://t.co/h3XgoxTFfi",25,['carry'],1,1,0,24,body bag,0
?? New Ladies Shoulder Tote #Handbag Faux Leather Hobo Purse Cross Body Bag #Womens http://t.co/zujwUiomb3 http://t.co/iap4LwvqsW,23,['body bag'],1,1,0,22,body bag,0
"#7294 Nikon D50 6.1 MP Digital SLR Camera Body 2 batteries carry bag and charger http://t.co/SL7PHqSGKV

$200.00
├½Ôûê_ http://t.co/T4Qh2OM8Op",25,['carry'],1,1,0,24,body bag,0
@fuckyeahcarey @BornVerified drake killing this dude and tea bagging the dead body at this point,17,"['drake', 'killing', 'bagging']",3,1,0,16,body bagging,0
Bagging the last spot on Body Attack ?????? #getin #traintuesday #lesmills,19,['Bagging'],1,1,0,18,body bagging,1
@Yankees body bagging mfs,5,"['body', 'bagging']",2,1,0,4,body bagging,0
'I did another one I did another one. You still ain't done shit about the other one.' Nigga body bagging Meek.,27,"['did', 'did', 'ai', 'done', 'shit', 'bagging']",6,1,0,26,body bagging,0
├½Ôûê┬ñ@MacDaddy_Leo: ?????? No Caption Needed ??. Freshman... http://t.co/k8ughv2aif├½Ôûê├ÿmy nigga Stacey body bagging niggas! ????,31,"['Needed', 'bagging']",2,1,0,30,body bagging,0
Aubrey really out here body-bagging Meek.,7,['body bagging'],1,1,0,6,body bagging,0
@FoxNews @JenGriffinFNC When you call to report dangerous activity tell em to have body bags on arrival.,20,"['call', 'report', 'tell', 'have']",4,1,0,19,body bags,1
RT Hamosh84: This how the #Saudi is coming home from #Yemen in body bags. For what? #Saudi Kingdom ego? You're loo├½Ôûê_ http://t.co/LJlKWGXgjY,32,"['is', 'coming', ""'re""]",3,1,0,31,body bags,0
"Fairfax Co. investigating firefighter Khalil Abdul-Rasheed for Facebook post saying police shld be put in body bags

http://t.co/VpvskCIyro",20,"['investigating', 'saying', 'be', 'put']",4,1,0,19,body bags,1
Womens Flower Printed Shoulder Handbags Cross Body Metal Chain Satchel Bags Pink http://t.co/vBZqWzNxH7 http://t.co/NXIhHeP1Ea,18,['Printed'],1,1,0,17,body bags,0
One of the top RT-ed tweets in #Japan is a screenshot of a young person claiming to not know the 70th anniversary of the Hiroshima bomb,27,"['is', 'claiming', 'know']",3,27,26,0,bomb,0
the_af comments on 'New evidence of Japan's effort to build atom bomb at the end of WWII' - http://t.co/hcTxghR2Yf,23,['build'],1,13,12,10,bomb,1
Hiroshima prepares to remember the day the bomb dropped http://t.co/oJHCGZXLSt,12,"['prepares', 'remember', 'dropped']",3,8,7,4,bomb,0
The Guardian view on the Hiroshima legacy: still in the shadow of the bomb | Editorial: The world longs to cas... http://t.co/RhxMGhsPd7,27,"['longs', 'cas']",2,15,14,12,bomb,0
New Documents Found Pointing To Japan's WWII Atomic Bomb Program http://t.co/IucPcSfbMT,14,"['Found', 'Pointing']",2,1,0,13,bomb,0
RIP RT @AJENews: On Aug. 6 1945 at 8:16 AM Tokyo time the world├½Ôûê┬¼s 1st atom bomb on Hiroshima http://t.co/6Q5CS9MCdW http://t.co/7OGFoQr0MG,27,['bomb'],1,19,18,8,bomb,0
@smallforestelf Umm because a gun stopped the gunman with who was carrying a bomb!,16,"['stopped', 'was', 'carrying']",3,15,14,1,bomb,1
@joshrogin @slwsew379 @jimsciutto @NatSecCNN As suspected. Kerry and Barry got taken for a ride. Iran was making a bomb while talks went on.,30,"['suspected', 'got', 'taken', 'was', 'making', 'went']",6,25,24,5,bomb,0
Why American censors supressed accounts of suffering in Nagasaki http://t.co/kZbeas50KE http://t.co/YQgpaSX3MG,15,"['supressed', 'suffering']",2,1,0,14,bomb,0
New Documents Found Pointing To Japan's WWII Atomic Bomb Program http://t.co/M9mowCMVNj,14,"['Found', 'Pointing']",2,1,0,13,bomb,1
Hiroshima marks 70 years since bomb http://t.co/3u6MDLk7dI,9,['marks'],1,6,5,3,bomb,0
The crew on #EnolaGay had nuclear bomb on board disarmed. 15 mins to #Hiroshima they got ready to arm Little Boy http://t.co/JB25fHKe6q,27,"['had', 'disarmed', 'got', 'arm']",4,8,7,19,bomb,1
What if your hometown were hit by the Hiroshima atomic bomb? http://t.co/XuWN4McgYp #safemode,17,"['were', 'hit']",2,11,10,6,bomb,0
If I fall is men GOD @Praiz8 is d bomb well av always known dat since 2008 bigger u I pray sir,23,"['fall', 'is', 'is', 'known', 'pray']",5,11,10,12,bomb,0
I came up with an idea of a fragrance concept for a bath bomb called The Blood of my Enemies. So you can say that's what you bathe in.,32,"['came', 'called', 'say', ""'s"", 'bathe']",5,14,13,18,bomb,0
@johncusack text: We Dropped The A-Bomb (1946)https://t.co/boJCX32qcZ ├½Ôûê_,15,['Dropped'],1,1,0,14,bomb,0
&lt;Kyodonews&gt; UPDATE1: Hiroshima marks 70th A-bomb anniv. amid fears of eroded pacifism http://t.co/VpGu8z1Lhb #followme #japan,27,['marks'],1,1,0,26,bomb,0
@SwellyJetEvo Disneyland! Tacos there are bomb!,9,['are'],1,8,7,1,bomb,1
What would it look like if Hiroshima bomb hit Detroit?: Thursday marks the 70-year anniversary of the United S... http://t.co/6sy44kyYsD,25,"['look', 'hit', 'marks']",3,8,7,17,bomb,0
The hatchet-wielding gunman had PEPPER SPRAY AND A FAKE BOMB?!?!?,15,['had'],1,1,0,14,bomb,1
"Oops.
H bomb lost 70 miles off the Okinawan coast.
Fell off the ship 1965.
http://t.co/yVsJyzwxJR",20,['lost'],1,4,3,16,bomb,1
The Guardian view on the Hiroshima legacy: still in the shadow of the bomb | Editorial: The world longs to cas... http://t.co/ct2JUtvYTg,27,"['longs', 'cas']",2,15,14,12,bomb,0
@SweetieBirks @mirrorlady2 @SLATUKIP So name all the countries we've invaded/bombed aside Libya in North Africa in last 5 years.....,25,"[""'ve"", 'invaded/bombed']",2,1,0,24,bombed,0
The U.S. bombed Hiroshima 70 years ago today. A look at how war has changed since: http://t.co/UQnj6nk9y3 http://t.co/QLnnMxzFqK,24,"['bombed', 'has', 'changed']",3,3,2,21,bombed,0
At this hour 70 yrs ago one of the greatest acts of mass murder in world history occurred when #Hiroshima was bombed. http://t.co/2QJl5MfKzv,27,"['occurred', 'was', 'bombed']",3,23,22,4,bombed,0
70 years ago nowish America bombed #Hiroshima. Was it justified? All I can say is #noMOREHiroshimas #VJDay70 #FEPOW http://t.co/SYADSa6QeS,27,"['bombed', 'Was', 'justified', 'say', 'is']",5,6,5,21,bombed,0
US drone bombs Islamic State target in Syria after taking off from Turkey: A US armed drone has bombed a targe... http://t.co/m0daP5xLwo,26,"['taking', 'armed', 'has', 'bombed']",4,20,19,6,bombed,1
@CyhiThePrynce bombed on Kanye in that #ElephantInTheRoom ????????,17,['bombed'],1,3,2,14,bombed,1
#Hiroshima does not look like a bombed city. It looks as if a monster steamroller had passed over it and squashed it out of existence.,28,"['does', 'look', 'looks', 'had', 'passed', 'squashed']",6,8,7,20,bombed,0
The majority of those killed were civilians on the ground after the jet first bombed the city's main street then dramatically plummeted,23,"['killed', 'were', 'bombed', 'plummeted']",4,15,14,8,bombed,1
70 years ago at this hour the USA A-bombed Hiroshima therein killing 200000 civilians. Never forget the crime and never repeat. Peace ??,26,"['therein', 'killing', 'forget']",3,1,0,25,bombed,0
On 1st August #Turkish jets bombed the village Zergele in Qendil and killed 8 civilians and 15 others wounded,20,"['bombed', 'killed', 'wounded']",3,7,6,13,bombed,1
@NickLee8  i went to school in a bombed out East End of London3 families to one house no bathroom outside loo &amp; poor so whats yr point,30,"['went', 'bombed']",2,9,8,21,bombed,1
6th July 1945 ...Hiroshima was bombed with nuclear weapon _bomb was named little boy&amp;carried in a plane called Enola Gay ...1/2,27,"['was', 'bombed', 'was', 'named', 'carried', 'called']",6,7,6,20,bombed,0
"'the third generation atomic bombed survivor' Photo exhibition 11:00 to 18:00 8/6. 
#?? #Hiroshima http://t.co/gVAipmLSl0",22,['bombed'],1,5,4,17,bombed,0
Shadowflame and the Wraith: Bombed http://t.co/LDBaO0rSuz via @amazon,12,['bombed'],1,1,0,11,bombed,0
@WhiteHouse @POTUS Just cos Germany invaded Poland Japan bombed Pearl Harbor PRE-EMPTIVE SUICIDE http://t.co/I2AAG6Lp6W,18,"['invaded', 'bombed']",2,11,10,7,bombed,0
http://t.co/wMNOnHxEIr 'Nagasaki has to be forever the last city bombed with a nuclear weapon.' #bannukes,20,"['has', 'be', 'bombed']",3,12,11,8,bombed,0
.@Vagersedolla visits villages recently bombed by Turkey and finds people fed up with the PKK http://t.co/UUWEiKD7sP,20,"['bombed', 'finds', 'fed']",3,7,6,13,bombed,0
@antpips67 @JohnEJefferson obviously I'm aware that not all AS are from countries we have bombed but a lot are fleeing conflict,24,"[""'m"", 'are', 'have', 'bombed', 'are', 'fleeing']",6,18,17,6,bombed,0
'Redskins WR Roberts Belly-Bombed ' via @TeamStream http://t.co/GbcvVEvDTY,11,['bombed'],1,1,0,10,bombed,0
#SitCTips if you do vlog you WILL get video-bombed.,11,"['do', 'vlog', 'get']",3,1,0,10,bombed,0
Today Japan marks 70 yrs since the U.S (A) bombed 2 cities killing over 120000 people But we have to worry about Iran http://t.co/FcIXk23XQH,28,"['marks', 'bombed', 'killing', 'have', 'worry']",5,12,11,16,bombed,0
She didn't even notice me in the background I'm a floatin head #bombed http://t.co/JA0WGp8sPe,19,"['did', 'notice', ""'m""]",3,16,15,3,bombed,0
70 years ago today the United States of America bombed Hiroshima in Japan.,14,['bombed'],1,10,9,4,bombed,0
Storm in RI worse than last hurricane. My city&amp;3others hardest hit. My yard looks like it was bombed. Around 20000K still without power,30,"['looks', 'was', 'bombed']",3,24,23,6,bombed,1
Bombing of Hiroshima 1945. http://t.co/4UHq9jKCvq,7,['bombing'],1,1,0,6,bombing,0
We dont really talk about the murder of the bombing campaigns in WWII because we won but murder it is. https://t.co/jsGwnY6kdJ,24,"['dont', 'talk', 'won', 'is']",4,10,9,14,bombing,0
The United Kingdom and France are bombing Daesh in Syria - Voltaire Network http://t.co/zYSsObXNtC,16,"['are', 'bombing']",2,7,6,9,bombing,1
It's been 70 years (and one hour) since the bombing of Hiroshima. Let's take this time to remember.,24,"[""'s"", 'been', 'Let', 'take', 'remember']",5,13,12,11,bombing,0
The cryptic words that guided pilots on the Hiroshima bombing mission http://t.co/FCe0K1Ihti,14,"['guided', 'bombing']",2,10,9,4,bombing,0
Japan on Thursday marks the 70th anniversary of the atomic bombing of Hiroshima with the most senior official from Washington ever schedule├½Ôûê_,22,"['marks', 'schedule├½Ôûê_']",2,11,10,11,bombing,0
#Hiroshima marks 70th anniversary of atomic bombing ( via NHK WORLD News) http://t.co/qGWoyNJLY8,17,['bombing'],1,8,7,9,bombing,0
Today marks the 70th anniversary of the bombing of Hiroshima a city I visited and was humbled by in November 2013 http://t.co/AcC1z5Q9Zw,24,"['marks', 'visited', 'was', 'humbled']",4,8,7,16,bombing,0
@moscow_ghost @sayed_ridha @Amin_Akh congratulations on capturing a besieged city after 3 months of indiscriminate bombing by land &amp; air,24,"['capturing', 'besieged']",2,18,17,6,bombing,0
"The only country claiming the moral high ground is the only one to have dropped atomic bombs. #Hiroshima #BanTheBomb
http://t.co/6G49ywwsQJ",25,"['claiming', 'is', 'have', 'dropped']",4,1,0,24,bombing,0
The cryptic words that guided pilots on the Hiroshima bombing mission http://t.co/nSS5L64cvR #canada,16,"['guided', 'bombing']",2,10,9,6,bombing,0
Japan to mark 70th anniversary of Hiroshima atomic bombing http://t.co/RUQPVtdBzT,12,['mark'],1,9,8,3,bombing,0
Just Happened in Asia: Japan marks 70th anniversary of Hiroshima atomic bombing http://t.co/E5dEmdScEh,16,"['Happened', 'marks']",2,13,12,3,bombing,0
What it was like to survive the atomic bombing of Hiroshima http://t.co/0cvXS2E1Er,14,"['was', 'survive']",2,9,8,5,bombing,0
#Setting4Success Bells toll in Hiroshima as Japan marks 70 years since atomic bombing #News #smallbusiness #entrepreneur,20,['marks'],1,14,13,6,bombing,0
#Australia #News ; #Japan marks 70th anniversary of #Hiroshima atomic bombing  http://t.co/7aD0L7cgee READ MORE; http://t.co/hHzQl9tzNP,24,['marks'],1,15,14,9,bombing,0
@NBCNews Yea bombing #pearlharbor not so good of an idea!,13,['bombing'],1,4,3,9,bombing,0
The cryptic words that guided pilots on the Hiroshima bombing mission http://t.co/39IAbcC5pK,14,"['guided', 'bombing']",2,10,9,4,bombing,0
70th anniversary of Hiroshima atomic bombing marked  http://t.co/1mGvd4x5Oe,10,['marked'],1,6,5,4,bombing,0
Japan Marks 70th Anniversary of Hiroshima Atomic Bombing http://t.co/cQLM9jOJOP,11,['bombing'],1,1,0,10,bombing,0
Japan Marks 70th Anniversary of Hiroshima Atomic Bombing http://t.co/3EV07PPaPn,11,['bombing'],1,1,0,10,bombing,0
70th Anniversary of Hiroshima bombing https://t.co/juwvomhGPd,8,['bombing'],1,5,4,3,bombing,0
Japan Marks 70th Anniversary of Hiroshima Atomic Bombing http://t.co/jzgxwRgFQg,11,['bombing'],1,1,0,10,bombing,0
@rinkydnk2 @ZaibatsuNews @NeoProgressive1 When push2Left talk='ecology'&amp;'human rts'&amp;'democracy'. War Afghetc='Left' humanitarian bombing,27,['amp'],1,27,26,0,bombing,0
Hiroshima bombing justified: Majority Americans even today - Hindustan Times http://t.co/cC9z5asVZh,14,['bombing'],1,2,1,12,bombing,0
Japan marks the 70th anniversary of the atomic bombing of Hiroshima. http://t.co/YmKn1IwPvF http://t.co/mMmJ8Bo9y3,18,['marks'],1,9,8,9,bombing,0
'Japan Marks 70th Anniversary of Hiroshima Atomic Bombing' by THE ASSOCIATED PRESS via NYT http://t.co/kKULqGB9e3,18,['bombing'],1,1,0,17,bombing,0
@snapharmony : Bells toll in Hiroshima as Japan marks 70 years since atomic bombing http://t.co/yPvvqZ8jzt,18,['marks'],1,15,14,3,bombing,0
Japan marks 70th anniversary of Hiroshima atomic bombing http://t.co/a2SS7pr4gW,11,['marks'],1,8,7,3,bombing,0
The 'sanitised narrative' of Hiroshima's atomic bombing. #Hiroshima70 #japan http://t.co/zsyj6sqYCn,17,['bombing'],1,9,8,8,bombing,0
#Japan marks 70th anniversary of #Hiroshima atomic bombing (from @AP) http://t.co/qREInWg0GS,18,['marks'],1,10,9,8,bombing,0
Today is the day Hiroshima got Atomic bomb 70 years ago.  - The 'sanitised narrative' of Hiroshima's atomic bombing http://t.co/GKpANz7vg0,25,"['is', 'got']",2,22,21,3,bombing,0
"What it was like to survive the atomic bombing of Hiroshima
http://t.co/LGrOcbXPqo",14,"['was', 'survive']",2,9,8,5,bombing,0
Japan marks 70th anniversary of Hiroshima atomic bombing: Bells tolled in Hiroshima on Thursday as Japan marke... http://t.co/IqAIRPdIhg,22,"['marks', 'tolled']",2,8,7,14,bombing,0
Japan on Thursday marks the 70th anniversary of the atomic bombing of Hiroshima with the most senior official from Washington ever schedule├½Ôûê_,22,"['marks', 'schedule├½Ôûê_']",2,11,10,11,bombing,0
Japan marks 70th anniversary of Hiroshima atomic bombing http://t.co/MLZxmGVuIh,11,['marks'],1,8,7,3,bombing,0
70 yrs since the atomic bombing of Hiroshima... Terrible mass murder...,13,['bombing'],1,6,5,7,bombing,0
Japan marks 70th anniversary of Hiroshima atomic bombing: Bells tolled in Hiroshima on Thursday as Japan marked 70├½Ôûê_ http://t.co/NBZiKcJpHp,22,"['marks', 'tolled', 'marked']",3,8,7,14,bombing,0
Japan marks 70th anniversary of Hiroshima atomic bombing #Generalnews http://t.co/M9o08GUrT4,13,['marks'],1,8,7,5,bombing,0
@ameenshaikh3 by ur. logic if bridge didnt collapse then second train engine should cross bridge then  @sanjaynirupam @sureshprabhu,22,"['ameenshaikh3', 'cross']",2,1,0,21,bridge collapse,1
"Australia's Ashes disaster - how the collapse unfolded at Trent Bridge... http://t.co/Dq3ddGvgBF
 #cricket",18,['unfolded'],1,1,0,17,bridge collapse,0
BREAKING NEWS: Australia collapse to a hapless 60 all out at Trent Bridge http://t.co/O2CFWDzZld,17,['bridge collapse'],1,1,0,16,bridge collapse,1
Sioux City Fire Officials Believe Bridge Collapse Lead To Cement Truck Roll Over - Siouxland Matters: Siouxlan... http://t.co/sZTGmbkoHG,22,['bridge collapse'],1,1,0,21,bridge collapse,1
Ashes 2015: Australia├½Ôûê┬¼s collapse at Trent Bridge among worst in history: England bundled out Australia for 60 ... http://t.co/985DwWPdEt,23,['bundled'],1,1,0,22,bridge collapse,0
2 Injured 1 missing in bridge collapse in central Mexico http://t.co/kHF0iH05A9,13,['missing'],1,1,0,12,bridge collapse,1
I never knew about the relationship btwn Kansas City Hyatt bridge collapse &amp; AIA's COTE.   http://t.co/ThS9IqSWP3 via @HuffPostArts,25,['knew'],1,1,0,24,bridge collapse,0
New: Two giant cranes holding a bridge collapse into nearby homes http://t.co/ACirPv8Hn4,15,['holding'],1,1,0,14,bridge collapse,0
@AkinwunmiAmbode Urgentthere is currently a 3 storey building at church B/stop Oworoshoki Third mainland bridge which likely to collapse,20,"['is', 'collapse']",2,1,0,19,bridge collapse,1
"Throwback Thursday: More Thoughts About Citizen Media During Minneapolis Bridge Collapse Disaster - http://t.co/GudUDAZ4fx 
#TBT",19,['bridge collapse'],1,1,0,18,bridge collapse,0
What the fuck is going on at Trent Bridge?!  Reminds me of England's collapse out in the Caribbean back in the 90s...,26,"['is', 'going']",2,1,0,25,bridge collapse,0
Swiss Kosher Hotel Bridge Collapse Injures Five People - http://t.co/TxIestoX5n @JewishPress,14,['bridge collapse'],1,1,0,13,bridge collapse,1
Bridge collapse not natural calamity but man-made: MPP lambasts Congress - KanglaOnline http://t.co/jp9XylA3C5  #Yugvani,18,['lambasts'],1,1,0,17,bridge collapse,1
Two giant cranes holding a bridge collapse into nearby homes http://t.co/OQpsvrGbJc,13,['holding'],1,1,0,12,bridge collapse,1
ICYMI - #Ashes 2015: Australia collapse at Trent Bridge - how Twitter reacted http://t.co/gl6eeJyJkY http://t.co/wqtDnP3w5a,21,['reacted'],1,1,0,20,bridge collapse,0
Warne shocked over Australia's epic collapse at Trent Bridge: Johannesburg Aug 06 (ANI): Legendary Australian... http://t.co/LwwoJXtTIV,24,['shocked'],1,1,0,23,bridge collapse,0
Two giant cranes holding a bridge collapse into nearby homes http://t.co/UmANaaHwMI,13,['holding'],1,1,0,12,bridge collapse,1
2 Injured 1 missing in bridge collapse in central Mexico - Fox News Latino http://t.co/l0UnaFLy0Y,17,['missing'],1,1,0,16,bridge collapse,1
Two giant cranes holding a bridge collapse into nearby homes http://t.co/5t69Ev0xTi via http://t.co/Nyp8OQ2Z9T,17,['holding'],1,1,0,16,bridge collapse,1
#TrainTragedy - Happened in MP due to collapse of bridge now I m afraid to take a long distance train. http://t.co/JthusynJaH,25,"['Happened', 'm', 'take']",3,1,0,24,bridge collapse,1
Two giant cranes holding a bridge collapse into nearby homes http://t.co/Mqm46H6G8b,13,['holding'],1,1,0,12,bridge collapse,0
"Throwback Thursday: Minneapolis Bridge Collapse &amp; Citizen Journalism - http://t.co/bXV3vlMBBp 
#TBT http://t.co/iBmqVWrVyz",20,['bridge collapse'],1,1,0,19,bridge collapse,0
Two giant cranes holding a bridge collapse into nearby homes http://t.co/jBJRg3eP1Q,13,['holding'],1,1,0,12,bridge collapse,1
Two giant cranes holding a bridge collapse into nearby homes http://t.co/gSKJqWyI2d,13,['holding'],1,1,0,12,bridge collapse,1
#computers #gadgets Two giant cranes holding a bridge collapse into nearby homes http://t.co/UZIWgZRynY #slingnews,19,['holding'],1,1,0,18,bridge collapse,1
Australia's Ashes disaster - how the collapse unfolded at Trent Bridge - Telegraph http://t.co/6FYnerMUsG,17,['unfolded'],1,1,0,16,bridge collapse,0
@followlasg This is urgentthere is currently a 3 storey building at church B/stop Oworoshoki Third mainland bridge which likely to collapse,22,"['is', 'is', 'collapse']",3,1,0,21,bridge collapse,1
Australia collapse at Trent Bridge how Twitter . On the first morning of the fourth Ashes Test... http://t.co/WAtjhzULa8,21,['bridge collapse'],1,1,0,20,bridge collapse,0
Two giant cranes holding a bridge collapse into nearby homes http://t.co/lSQe7nu6kl,13,['holding'],1,1,0,12,bridge collapse,1
Two giant cranes holding a bridge collapse into nearby homes http://t.co/q5q1x5Vcqk,13,['holding'],1,1,0,12,bridge collapse,1
Shane Warne and Ricky Ponting shocked by Australia batting collapse at Trent Bridge http://t.co/b5zPfW7Vo0,16,"['shocked', 'batting']",2,1,0,15,bridge collapse,0
Ashes 2015: Australia collapse at Trent Bridge - how Twitter reacted http://t.co/ik7mGidvbm http://t.co/AF1yzUS8LN,18,['reacted'],1,1,0,17,bridge collapse,0
Mexico: construction of bridge collapse kills├òÔò®one http://t.co/I2C00FcOwb http://t.co/jAAgcFaRTW,13,['bridge collapse'],1,1,0,12,bridge collapse,1
2 Injured 1 missing in bridge collapse in central Mexico http://t.co/scDa8eVwR6,13,['missing'],1,1,0,12,bridge collapse,1
Two cranes restoring a bridge in the central Dutch town of Alphen aan den Rijn collapse on to buildings with rescuers searching for,23,"['restoring', 'searching']",2,1,0,22,bridge collapse,1
Two giant cranes holding a bridge collapse into nearby homes http://t.co/9asc1hhFNJ,13,['holding'],1,1,0,12,bridge collapse,1
5 injured in bridge collapse at Swiss kosher hotel: The accident occurred on Tuesday at the Metropol Hotel a ... http://t.co/sIGeZlynJ9,24,"['injured', 'occurred']",2,1,0,23,bridge collapse,1
US wont upgrade its infrastructure? http://t.co/NGEHhG9YGa' it a bad situation and its going to get ugly very quickly #USA #sustainability,26,"['wont', 'upgrade', 'going', 'get']",4,1,0,25,bridge collapse,0
@ameenshaikh3 sir i just only wanted to make a point about @sureshpprabhu you made and said he is lying about bridge collapse.,25,"['wanted', 'make', 'made', 'said', 'is', 'lying']",6,1,0,24,bridge collapse,0
'i'm a Gemini' *children screaming buildings burning police sirens in the distance*,15,"[""'m"", 'screaming', 'burning']",3,1,0,14,buildings burning,0
Mmmmmm I'm burning.... I'm burning buildings I'm building.... Oooooohhhh oooh ooh...,19,"[""'m"", 'burning', ""'m"", 'burning', ""'m"", 'building']",6,1,0,18,buildings burning,1
@DougMartin17 Fireman Ed runs into burning buildings while others are running out Doug he deserves your respect??????,24,"['runs', 'burning', 'are', 'running', 'deserves']",5,1,0,23,buildings burning,0
@themagickidraps not upset with a rally upset with burning buildings businesses executing cops that have nothing to do with it etc,22,"['upset', 'upset', 'executing', 'have', 'do']",5,1,0,21,buildings burning,0
@_minimehh @cjoyner I must be overlooking the burning buildings? #BlackLivesMatter,14,"['be', 'overlooking']",2,1,0,13,buildings burning,0
@fewmoretweets all lives matter. Just not a fan of burning down buildings and stealing from your neighbors to 'protest',22,"['burning', 'stealing', ""'protest""]",3,1,0,21,buildings burning,0
@CTVKathyLe and in other news: don't run into burning buildings,13,"['do', 'run']",2,1,0,12,buildings burning,0
forestservice : RT dhsscitech: #Firefighters run into burning buildings├½Ôûê├ïwe work on #tech t├½Ôûê_ http://t.co/KybQcSvrZa) http://t.co/Ih49kyMsMp,23,"['run', 'burning']",2,1,0,22,buildings burning,1
The Rocky Fire burning in northern California is still threatening more than 7000 buildings. It's the largest in the state #9newsmornings,24,"['is', 'threatening', ""'s""]",3,1,0,23,buildings burning,1
Like how are ppl not burning these buildings down knowing why it was originally created?,16,"['are', 'burning', 'knowing', 'was', 'created']",5,1,0,15,buildings burning,0
"Messi: has tattoos so he can't donate blood
Ronaldo: runs into burning buildings to save dogs #respect",21,"['has', 'donate', 'runs', 'burning', 'save']",5,1,0,20,buildings burning,0
I can probably skip on these basic life maintenance things for a few days. (cut to burning buildings people screaming in the streets),26,"['skip', 'cut', 'burning', 'screaming']",4,1,0,25,buildings burning,0
@1acd4900c1424d1 @FoxNews no one is rioting burning down buildings or looting.,14,"['is', 'rioting', 'burning']",3,1,0,13,buildings burning,0
@chistate33 @thehill What hate crimes? It's the looney libs that are always burning down buildings and vandalzing private property,23,"['thehill', 'hate', ""'s"", 'are', 'burning', 'vandalzing']",6,1,0,22,buildings burning,0
into burning fucking buildings (2/2),7,['burning'],1,1,0,6,buildings burning,0
Port Coquitlam fire burning several businesses http://t.co/Q5FzYLBvTk,9,['burning'],1,1,0,8,buildings burning,1
@speechgirlAM On par with caring for the sick helping people move not talking during movies rescuing people from burning buildings...,22,"['caring', 'helping', 'move', 'talking', 'rescuing', 'burning']",6,1,0,21,buildings burning,0
Schools in Western Uganda still Burning down Buildings during Strikes....Strikes in Western Uganda always Lit literally..,18,"['Burning', '.Strikes']",2,1,0,17,buildings burning,0
@DoctorFluxx @StefanEJones @spinnellii @themermacorn  No burning buildings and rob during a riot. That's embarrassing &amp; ruining this nation.,27,"['spinnellii', ""'s"", 'embarrassing', 'ruining']",4,1,0,26,buildings burning,0
People are more worried about the burning of buildings than black people losing their lives disgusting.,17,"['are', 'losing', 'disgusting']",3,1,0,16,buildings burning,0
Bradford. Back to doing what we do best. Burning down our own buildings. Read it and weep Leeds. https://t.co/OLnfzb86zb,25,"['doing', 'do', 'Burning', 'Read']",4,1,0,24,buildings burning,0
@EPCOTExplorer my jealous tears are burning with the fire of a thousand ransacked buildings. SO AWESOMEEEEEEEE,18,"['are', 'burning', 'ransacked']",3,1,0,17,buildings burning,0
@zourryart I forgot to add the burning buildings and screaming babies,12,"['forgot', 'add', 'screaming']",3,1,0,11,buildings burning,0
Sinking ships burning buildings &amp; Falling objects are what reminds me of the old us.,18,"['Sinking', 'burning', 'are', 'reminds']",4,1,0,17,buildings burning,0
like for the music video I want some real action shit like burning buildings and police chases not some weak ben winston shit,23,"['want', 'burning']",2,1,0,22,buildings burning,0
Burning buildings? Media outrage? http://t.co/pHixZnv1YN,9,['Burning'],1,1,0,8,buildings burning,0
"Must get hot in burning buildings

-loses followers- https://t.co/8sP8xLbbDR",11,"['get', 'burning', '-loses']",3,1,0,10,buildings burning,0
Two buildings burn in 3-alarm Antioch fire: Two buildings are burning in a 3-alarm fire at the Delta Pines├½Ôûê_ http://t.co/GQgF2ygpX2,23,"['burn', 'are', 'burning']",3,1,0,22,buildings burning,1
.@denisleary Not sure how these folks rush into burning buildings but I'm grateful they do. #TrueHeroes,21,"['rush', 'burning', ""'m"", 'do']",4,1,0,20,buildings burning,0
Witness video shows car explode behind burning buildings on 2nd St this afternoon #Manchester  http://t.co/cgmJlSEYLo via @MikeCroninWMUR,21,"['shows', 'burning']",2,1,0,20,buildings burning,0
Watching Xela firefighters struggle to save burning buildings last night w/ old equipment makes me so grateful for DCFD @ChR3lyc @IAFF36,23,"['Watching', 'struggle', 'save', 'makes']",4,1,0,22,buildings burning,1
"http://t.co/WRB7Xd8W5y
CROYDON RIOTS- The Next Day: Burning Buildings in High Street &amp; crowds at Reeves Corner
Croydonization
August 2011",24,['buildings burning'],1,1,0,23,buildings burning,1
Fire hazard associated with installation of non-compliant external cladding on http://t.co/bTPQdehl3p - By @www.cbplawyers,17,['associated'],1,1,0,16,buildings on fire,1
.@greenbuildermag @NFPA to hold free webinar on #wildfire mitigation 8/19 at 2pm ET. http://t.co/xmsvOHKccP @Firewise @Michele_NFPA,25,['hold'],1,1,0,24,buildings on fire,0
Video:  Fire burns two apartment buildings and blows up car in Manchester http://t.co/5BGcw3EzB5,16,['blows'],1,1,0,15,buildings on fire,1
Fire destroys two buildings on 2nd Street in #Manchester http://t.co/Tqh5amoknd,13,['destroys'],1,1,0,12,buildings on fire,1
Multiple Buildings On Fire In Downtown Hinton http://t.co/P6kdh0p0Sp http://t.co/WaetKGsZA9,13,['buildings on fire'],1,1,0,12,buildings on fire,1
Buildings are on fire and they have time for a business meeting #TheStrain,14,"['are', 'have']",2,1,0,13,buildings on fire,1
Ton of smoke coming out of one of the new apartment buildings at 160 Ross in Auburn. Several fire trucks on scene. http://t.co/AHVYmSQHqC,27,['coming'],1,1,0,26,buildings on fire,1
I'm security so they want me to help out in case of emergency like the buildings on fire or a shooter's in the building. I'm leaving tho..,31,"[""'m"", 'want', 'help', ""'m"", 'leaving']",5,1,0,30,buildings on fire,0
fucking apartments across the street are on fire right now. 5 fuckin firetrucks wtf. this is the second time those buildings caught on fire,26,"['fucking', 'are', 'wtf', 'is', 'caught']",5,1,0,25,buildings on fire,1
Smoke detectors not required in all buildings: An office building on Shevlin-Hixon Drive was on fire. There we... http://t.co/z6Ee1jVhNi,24,"['required', 'was']",2,1,0,23,buildings on fire,0
"someone: mentions gansey on fire
me busting through the brick walls of seven different buildings:",17,"['gansey', 'busting']",2,1,0,16,buildings on fire,1
"There are multiple buildings on fire In Downtown Hinton OK.
The fire is threatening to level the entire block! #8NN https://t.co/pEVtSf7Cyt",26,"['are', 'is', 'threatening', 'level']",4,1,0,25,buildings on fire,1
Such beautiful architecture in #NYC I love those fire escape routes on the buildings. #newyork├½Ôûê_ https://t.co/fW1PtaElgV,21,['love'],1,1,0,20,buildings on fire,0
#TweetLikeItsSeptember11th2001 Those two buildings are on fire,8,['are'],1,1,0,7,buildings on fire,1
just in: #kenya: several buildings are reported to be on fire close to dam estate #langata at 2:22pm.,23,"['are', 'reported', 'be', 'dam']",4,1,0,22,buildings on fire,1
They are evacuating buildings in that area of State Road 20. We still don't have confirmation of what is on fire.,24,"['are', 'evacuating', 'do', 'have', 'is']",5,1,0,23,buildings on fire,1
@gilsimmons lightening struck &amp; 2 units in 1 of our buildings in our development on fire. Groton CT. Check out my FB wall most recent post,31,"['lightening', 'Check']",2,1,0,30,buildings on fire,1
"#Taiz
#Houthi #Saleh indiscriminate shelling from castle sets Tahreer st buildings on fire
#Yemen http://t.co/qsli2ivIoG",21,['shelling'],1,1,0,20,buildings on fire,0
shootings explosions hand grenades thrown at cars and houses &amp; vehicles and buildings set on fire. It all just baffles me.Is this Sweden?,27,"['thrown', 'set', 'me.Is']",3,1,0,26,buildings on fire,1
Buildings on fire behind Tisa's in Niceville @tristapnwfdn https://t.co/ACl1baBacR,13,['buildings on fire'],1,1,0,12,buildings on fire,1
Two buildings involved in fire on 2nd Street in #Manchester. @WMUR9 #wmur http://t.co/bCEUGsoi2r,19,['involved'],1,1,0,18,buildings on fire,1
"Agricultural Buildings on Fire - Aldwark - NYorks Fire &amp; Rescue Service 

Still grim news but fewer piglets caught up http://t.co/0kjCWG6pN9",25,['caught'],1,1,0,24,buildings on fire,1
Fire Displaces Families and Damages Two Buildings in Troy: Fire broke out on Fourth Street in├½Ôûê_ http://t.co/6HKw5qLPPt #Albany #NY #News,26,['broke'],1,1,0,25,buildings on fire,1
What news reports am I missing? Are there buildings on fire people shot etc. due to videos? #PPSellsBabyParts https://t.co/Wzc5r4XOqZ,25,"['am', 'missing', 'Are', 'videos']",4,1,0,24,buildings on fire,1
Multiple firefighters hospitalized after fighting a fire Manchester NH. #7News http://t.co/X1oYU5Y6bI,15,"['hospitalized', 'fighting']",2,1,0,14,buildings on fire,1
"There are multiple buildings on fire In Downtown Hinton OK.
The fire is threatening to level the entire block! #8NN https://t.co/GXDKLhxU22",26,"['are', 'is', 'threatening', 'level']",4,1,0,25,buildings on fire,1
#TweetLikeItsSeptember11th2001 Those two buildings are on fire,8,['are'],1,1,0,7,buildings on fire,0
Now on http://t.co/3sTH9lrBUn: PHOTOS: Flames rage through Manchester buildings in 3-alarm fire http://t.co/jQxM4gcQZ3 #NH1News,21,['rage'],1,1,0,20,buildings on fire,1
@BigSim50 nah Philly pundits are half the cause. They set buildings on fire to report on buildings being on fire.,23,"['are', 'set', 'report', 'being']",4,1,0,22,buildings on fire,1
MaFireEMS: RT WMUR9: Two buildings involved in fire on 2nd Street in #Manchester. WMUR9  http://t.co/QUFwXRJIql via KCarosaWMUR,23,['involved'],1,1,0,22,buildings on fire,1
Now on WSLS: fire burns multiple buildings in #Montgomery Co tips to make childcare less expensive &amp; rain. Join @jennasjems @PatrickWSLS,28,"['burns', 'tips', 'make', '@']",4,1,0,27,buildings on fire,1
I just wanted to watch Paper Towns but the buildings on fire ?????,17,"['wanted', 'watch']",2,1,0,16,buildings on fire,0
I hope the only time I end up on TV is when I'm being arrested for lighting buildings on fire.,22,"['hope', 'end', 'is', ""'m"", 'being', 'arrested', 'lighting']",7,1,0,21,buildings on fire,0
Charred remains of homes on 2nd St in Manchester NH after fire rips through 2 buildings damaging neighboring homes http://t.co/Ja3W1S3tmr,22,"['remains', 'damaging', 'neighboring']",3,1,0,21,buildings on fire,1
Three-alarm fire destroys two residential buildings a car in Manchester N.H. on Sunday afternoon http://t.co/rVkyj3YUVK,17,['destroys'],1,1,0,16,buildings on fire,1
1943: Poland - work party prisoners in the Nazi death camp Treblinka rebelled seizing small arms and setting buildings on fire. #history,25,"['rebelled', 'seizing', 'setting']",3,1,0,24,buildings on fire,0
17 people displaced after 3-alarm fire tore through 2 apartment buildings on Second Street in Manchester. -- http://t.co/NzqwTCYidv #MHT,23,['displaced'],1,1,0,22,buildings on fire,1
Hinton city officials confirm multiple buildings on fire currently evacuating people on Main Street. We're on our way @OKCFOX,22,"['confirm', 'evacuating', ""'re""]",3,1,0,21,buildings on fire,1
"My Happy Pensioner Stories
Safe Buildings: watching a report on unsafe cladding catching fire in Melbourne same... http://t.co/cnoxJB8XoQ",22,"['watching', 'cladding', 'catching']",3,1,0,21,buildings on fire,0
Multiple houses/buildings on fire in Kalispell http://t.co/1iyThVshgF,9,['buildings on fire'],1,1,0,8,buildings on fire,0
Fire burning on Pendleton has burned 300 acres: Smoke reported drifting over Temecula. http://t.co/ZR5RgbGh03,18,"['has', 'burned', 'reported', 'drifting']",4,6,5,12,burned,1
Family heartbroken.Mobile home at Nellis &amp; Cheyenne burned in fire. Kids were all ready to go back 2 school @News3LV http://t.co/VAf1RAiYQb,27,"['burned', 'were', 'go']",3,10,9,17,burned,0
This is why you should be burned at the stake ! https://t.co/YpezipY2NY,14,"['is', 'be', 'burned']",3,7,6,7,burned,0
Let me tell you Brandace brought it today at #NTC! Heat and all...we survived! Burned over 500├½Ôûê_ https://t.co/ILfd6wcGqg,25,"['Let', 'tell', 'brought', 'survived', 'Burned']",5,1,0,24,burned,0
All you have to do is look up sports riots on google and you'll see more than couches being burned.. You fr gotta go https://t.co/P1AmgINsYs,29,"['have', 'do', 'is', 'look', 'see', 'being', 'fr', 'got', 'go']",9,21,20,8,burned,0
@IrSolichin @9Tawan99 @178kakapo @POTUS The last 2 of 68 cities where everyone was burned to death. Terrorism on the grandest of scales,27,"['@', 'was', 'burned']",3,18,17,9,burned,1
burned 129 calories doing 24 minutes of Walking 3.5 mph brisk pace #myfitnesspal,14,"['burned', 'doing', 'Walking']",3,1,0,13,burned,0
Burned dog finds new home with young burn victim http://t.co/Pqrjvgvgxg,12,"['Burned', 'finds', 'burn']",3,1,0,11,burned,0
Mad River Complex fires have burned 14028 acres 8% contained: The Mad River Complex fires in Trinity County ... http://t.co/LfNIPpNOtO,24,"['have', 'burned', 'contained']",3,6,5,18,burned,1
Watch how bad that fool get burned in coverage this year. Dat dude is all-pro practice squad material,19,"['Watch', 'burned', 'is']",3,7,6,12,burned,0
Metal Cutting Sparks Brush Fire In Brighton: A brush fire that was sparked by a landowner cutting metal burned 10├½Ôûê_ http://t.co/rj7m42AtWS,24,"['Cutting', 'was', 'sparked', 'cutting', 'burned']",5,20,19,4,burned,1
hermancranston: WIRED : All these fires are burning through firefighters' budgets http://t.co/FSGAnfRgjH http://t.co/ju9zzu9TiO├½Ôûê_ ├½Ôûê_,20,"['are', 'burning', 'http']",3,9,8,11,burning,1
Geoengineering and burning of fossil fuels is making our global weather unstable. With temps up to 165├ò├¡ and biggest flood in past 200 years,25,"['Geoengineering', 'is', 'making']",3,3,2,22,burning,1
@JanelleBrown117 YES! We are comrades in sweat-seeking calorie-burning cardio-torture! We need all the support we can get- smile nod wave,23,"['are', 'need', 'get-', 'wave']",4,1,0,22,burning,0
501 sky news mandem in totteham going maddddd burning up fed cars an dem ting dere,16,"['going', 'burning']",2,9,8,7,burning,0
├½Ôûê├ï bulletproof and black like a funeral; the world around us is burning but we're so cold. http://t.co/uqssnAAtTu,23,"['is', 'burning', ""'re""]",3,14,13,9,burning,0
WoW Legion ├½Ôûê├è Slouching Towards The Broken Isles: Warlords of Draenor wasn├½Ôûê┬¼t close enough to The Burning Crusad... http://t.co/RKpmoMQMUi,23,['wasn├½Ôûê┬¼t'],1,1,0,22,burning,0
.@StacDemon with five burning questions for Chris Mullin and St. John├½Ôûê┬¼s in 2015-16: http://t.co/NmRVTHkvAh #SJUBB,21,"['@', 'burning']",2,6,5,15,burning,0
Leader of #Zionism STOP BURNING #Babies  https://t.co/6xYsDN2Xz0,11,['burning'],1,1,0,10,burning,0
Flames visible from fire in Tucson mountains: A lightning-caused fire burning in steep rocky terrain in mountains├½Ôûê_ http://t.co/zRTRPL77QV,21,['burning'],1,12,11,9,burning,1
@TheVenskus you led a killer workout today @TheSweatShoppe my core is burning. Now #gymtime #worktime #auditiontime #roccotime #noBS,26,"['led', 'is', 'burning']",3,14,13,12,burning,0
We will be burning up like neon lights??????,14,"['be', 'burning']",2,4,3,10,burning,0
Burning bridges is my forte!,6,"['Burning', 'is']",2,1,0,5,burning,0
My hand is burning,4,"['is', 'burning']",2,4,3,0,burning,0
The Arab autocracies: Burning down their house http://t.co/xcjRamGQ22 via @TheEconomist,14,['Burning'],1,1,0,13,burning,0
@TarekFatah you are burning in enemity of Pakistan .i m sure you will burn more and more,18,"['are', 'burning', 'burn']",3,5,4,13,burning,0
@Michael5SOS haha so would you say its so hot your balls are burning off????,19,"['say', 'are', 'burning']",3,14,13,5,burning,0
#?x?: :and to counter acts such as the burning of the Alexandrian library.,19,['counter'],1,14,13,5,burning,1
'CALIFORNIA IS BURNING:' Gov. Jerry Brown told reporters at a press conference that California is experiencing... http://t.co/arzeMSR7FQ,23,"['IS', 'told', 'is', 'experiencing']",4,1,0,22,burning,0
Killing Black Babies at Planned Parenthood where's the demonstrations looting of PP burning down the buildings Black Babies Lives Matter,21,"['Killing', ""'s"", 'burning', 'Lives']",4,1,0,20,burning buildings,1
'What is this accomplishing?! Burning is killing the buildings!' #TI5Quotes #TI5,17,"['is', 'accomplishing', 'is', 'killing']",4,1,0,16,burning buildings,0
the mv should just be them strutting like they mean it while buildings are burning up in the bg and flames everywhere how cool would that be,27,"['be', 'strutting', 'mean', 'are', 'burning', 'be']",6,1,0,26,burning buildings,1
@Louis_Tomlinson incredible? THE CHILDREN WERE SCREAMING BUILDINGS WERE BURNING AND I WAS DANCING IN THE ASHES,18,"['WAS', 'DANCING']",2,1,0,17,burning buildings,0
"Burning Buildings.

Keep The Flames Lit. ??????",14,"['Burning', 'Keep']",2,1,0,13,burning buildings,1
@fewmoretweets all lives matter. Just not a fan of burning down buildings and stealing from your neighbors to 'protest',22,"['burning', 'stealing', ""'protest""]",3,1,0,21,buildings burning,0
Three-alarm fire burning in Antioch apartment complex. @kron4news http://t.co/IH7cTORGRH,13,['burning buildings'],1,1,0,12,burning buildings,1
@RockBottomRadFM Is one of the challenges on Tough Enough rescuing people from burning buildings?,16,"['rescuing', 'burning']",2,1,0,15,burning buildings,0
@foxnewsvideo @AIIAmericanGirI @ANHQDC So ... where are the rioters looters and burning buildings????  WHITE LIVES MATTER!!!!!!,29,"['are', 'burning']",2,1,0,28,burning buildings,1
forestservice : RT dhsscitech: #Firefighters run into burning buildings├½Ôûê├ïwe work on #tech t├½Ôûê_ http://t.co/KybQcSvrZa) http://t.co/Ih49kyMsMp,23,"['run', 'burning']",2,1,0,22,buildings burning,1
@themagickidraps not upset with a rally upset with burning buildings businesses executing cops that have nothing to do with it etc,22,"['upset', 'upset', 'executing', 'have', 'do']",5,1,0,21,buildings burning,0
Destruction magic's fine just don't go burning down any buildings.,13,"[""'s"", 'do', 'go', 'burning']",4,1,0,12,burning buildings,0
Burning buildings? Media outrage? http://t.co/pHixZnv1YN,9,['Burning'],1,1,0,8,buildings burning,0
The Rocky Fire burning in CA still threatening more than 7k buildings. Largest in state &amp; one of nearly 2 dozen burning now #9newsmornings,28,['threatening'],1,1,0,27,burning buildings,1
I will never support looting or the burning of buildings but when seeing the people fight back against the police. I was proud,24,"['support', 'looting', 'seeing', 'fight', 'was']",5,1,0,23,burning buildings,0
.@denisleary Not sure how these folks rush into burning buildings but I'm grateful they do. #TrueHeroes,21,"['rush', 'burning', ""'m"", 'do']",4,1,0,20,buildings burning,0
Large fire burning several buildings causing evacuations in downtown Hinton: http://t.co/mtMkiMwiyy,14,"['burning', 'causing']",2,1,0,13,burning buildings,1
Heavy smoke pouring out of buildings on fire in Port Coquitlam http://t.co/GeqkdaO4cV http://t.co/Dg0bGzeCgM,17,"['smoke', 'pouring']",2,1,0,16,burning buildings,1
@_minimehh @cjoyner I must be overlooking the burning buildings? #BlackLivesMatter,14,"['be', 'overlooking']",2,1,0,13,buildings burning,0
@Trubeque Destruction magic's fine just don't go burning any buildings.,14,"['do', 'go', 'burning']",3,1,0,13,burning buildings,0
Strikers in Phalaborwa striking over the CHINESE taking their jobs. Strikers burning buildings attacking cars 2... http://t.co/08LnGClZsj,21,"['taking', 'burning', 'attacking']",3,1,0,20,burning buildings,1
"dog rendered a kitten from burning buildings
https://t.co/9cpWIEcEGv http://t.co/rZLYtneZ2u",13,"['rendered', 'burning']",2,1,0,12,burning buildings,0
Schools in Western Uganda still Burning down Buildings during Strikes....Strikes in Western Uganda always Lit literally..,18,"['Burning', '.Strikes']",2,1,0,17,buildings burning,1
@kshllcenterpri1 @Progress4Ohio burning down buildings what you mean like when you burnt down those black churches?,19,"['burning', 'mean', 'burnt']",3,1,0,18,burning buildings,0
Dudes will thoroughly express how stupid black ppl r for burning buildings in response to brutality but nvr mention them being mistreated.,23,"['express', 'burning', 'being', 'mistreated']",4,1,0,22,burning buildings,0
"You picture buildings burning to the ground from the basement to the streetlight. 

I'm not your drinking problem
a hole is in the sky.",27,"['picture', 'burning', ""'m"", 'is']",4,1,0,26,burning buildings,0
I Pledge Allegiance To The P.O.P.E. And The Burning Buildings of Epic City. ??????,21,['Pledge'],1,1,0,20,burning buildings,0
Where are the protests ? The riots? The burning buildings? How come you don't see any of that crap happening when... http://t.co/1QOchsPYbw,28,"['are', 'come', 'do', 'see', 'happening']",5,1,0,27,burning buildings,0
Insane bush fires in California. Be safe. https://t.co/jSlxTQ3NqS,12,['bush fires'],1,1,0,11,bush fires,1
@POTUS Would you please explain what you are going to do about the volcanoes &amp; bush fires spouting all that CO2 into the air?,28,"['please', 'explain', 'are', 'going', 'do', 'spouting']",6,1,0,27,bush fires,1
@marcoarment Middle of winter in Sydney we have had snow bush fires and 78 degree days in the last week.  Keeps you on your toes for sure.,30,"['have', 'had', 'snow']",3,1,0,29,bush fires,0
'When you attack PP you attack women's health &amp; when you attack women's health you attack America's health.' http://t.co/HXdG24MCQg,28,"['attack', 'attack', 'attack', 'attack']",4,1,0,27,bush fires,0
OMFG there are bush fires all over this tiny island. Our freaking house is gonna burn down.,20,"['are', 'is', 'gon', 'burn']",4,1,0,19,bush fires,1
Soaring temperature's in some southern US states causing bush fires pity @scotgov only allow rain in Scotland. #TweetLikeKez,22,"['Soaring', 'causing', '@']",3,1,0,21,bush fires,1
You know it's hot when there are bush fires right near your villa ????,18,"['know', ""'s"", 'are']",3,1,0,17,bush fires,1
Slash-and-burn blamed for bush fires in western St Thomas - http://t.co/5dJ6cHjFZP,13,['blamed'],1,1,0,12,bush fires,1
Drought fuels bush fires in Jamaica - http://t.co/ZDtDqQbAHC http://t.co/PsQCNsVfgP - @JamaicaObserver @cnewslive RE https://t.co/6ZGef8J8Bm,22,['bush fires'],1,1,0,21,bush fires,1
Bushfire causes first victim in Albania ::  The multiple fires in Albania have caused the first vict http://t.co/yuba6XmBlq #Bush,23,"['causes', 'have', 'caused']",3,1,0,22,bush fires,1
@DoriCreates @alhanda seems gov moonbeam between tokes blames bush for all the fires.,16,"['DoriCreates', 'seems', 'bush']",3,1,0,15,bush fires,0
Drove past the field on fire yesterday. Reminded me of the bush fires we used to get in South Africa. http://t.co/SN3dHuYnFe,25,"['past', 'Reminded', 'used', 'get']",4,1,0,24,bush fires,0
The Public Health Team was traumatised after the bush fires. Could #AppreciativeInquiry turn this around? http://t.co/soEa1GgbKj,21,"['was', 'traumatised', 'turn']",3,1,0,20,bush fires,0
Bush #food fires: http://t.co/Q1Y8lm7us9 http://t.co/TofLxOdyrX,11,['bush fires'],1,1,0,10,bush fires,1
Californian Bush Fires 2015 http://t.co/rjdX29wosp,7,['bush fires'],1,1,0,6,bush fires,0
28 Oct 1895: 'Bush Fires.' http://t.co/zCKXtFc9PT,11,['bush fires'],1,1,0,10,bush fires,0
@dacherryontop13 ohh there are bush fires in Spain like every year one time when we went swimming there were planes getting water to fight,25,"['are', 'went', 'swimming', 'were', 'getting', 'fight']",6,1,0,24,bush fires,0
Bush Fires are scary....even scarier when you go down and fight them,14,"['are', 'go', 'fight']",3,1,0,13,bush fires,0
[WATCH] Mother Nature halts Australia Blue Mountains bushfire http://t.co/xxA4rmFZ01,13,['bush fires'],1,1,0,12,bush fires,1
Drought fuels bush fires in Jamaica - http://t.co/0YMF6TXFcH http://t.co/3i3d2NGeNt - @JamaicaObserver @cnewslive RE https://t.co/jyIEkEo2he,22,['bush fires'],1,1,0,21,bush fires,1
@JohnFromCranber  Pleas FOR global warming don't really work when California / Australia keep having catastrophic 'bush' fires.,21,"['do', 'work', 'keep', 'having']",4,1,0,20,bush fires,0
@jiminswang i was about 2 say bush fires in aus but the reason is hot,16,"['was', 'say', 'is']",3,1,0,15,bush fires,0
Bushfire causes first victim in Albania ::  The multiple fires in Albania have caused the first vict http://t.co/yuba6XmBlq #Bush,23,"['causes', 'have', 'caused']",3,1,0,22,bush fires,1
SMH photographer Wolter Peeters was on the front line with NSW Rural Fire Service crews la├½Ôûê_ http://t.co/gXe7nHwZ3e http://t.co/sRbqlMuwbV,22,"['was', 'crews']",2,1,0,21,bush fires,0
So apparently there were bush fires near where I live over the weekend that I was totally oblivious to...,20,"['were', 'live', 'was']",3,1,0,19,bush fires,1
California Bush fires please evacuate affected areas ASAP when california govts advised you to do so http://t.co/ubVEVUuAch,19,"['fires', 'please', 'affected', 'advised', 'do', 'http']",6,1,0,18,bush fires,1
@PamelaMueller @TIME  It is an honour  and privlege to pray. I have witnessed these bush fires when living in Australia,23,"['is', 'pray', 'have', 'witnessed', 'living']",5,1,0,22,bush fires,0
@TheRealPBarry How much CO2 does an erupting volcano and bush fires raging put into the atmosphere? None of the believers mention this.,25,"['does', 'erupting', 'raging']",3,1,0,24,bush fires,0
The Bush fires in CA are so crazy,8,['are'],1,1,0,7,bush fires,1
All these Eugene fires gotta make you think.... Hashtag conspiracies hashtag population control hashtag bush did it,20,"['got', 'make', 'think', 'hashtag', 'hashtag', 'did']",6,1,0,19,bush fires,0
"??
Warfighting Robots Could Reduce Civilian Casualties So Calling for a Ban Now Is Premature - IEEE Spectrum http://t.co/TzR58B86qz",22,"['Warfighting', 'Is']",2,1,0,21,casualties,0
Another movie theater attack..close to home this time. Thankful for no casualties. Life will go on because we cannot allow evil to win!,27,"['attack..close', 'home', 'go', 'allow', 'win']",5,13,12,14,casualties,0
Civilian casualties rise as Afghan war intensifies in 2015-- http://t.co/NnylXhInPx,13,['rise'],1,2,1,11,casualties,1
Afghan conflict sees 'sharp rise' in female casualties http://t.co/4hcYwRWN6L http://t.co/2TwXZ6vxbx,15,"[""'sharp"", 'http']",2,9,8,6,casualties,1
Warfighting Robots Could Reduce Civilian Casualties So Calling for a... http://t.co/9DVU1RidZ3,14,['Warfighting'],1,1,0,13,casualties,1
American Weapons and Support Are Fueling a Bloody Air War in Yemen http://t.co/ZBLU4xXo44,15,['Fueling'],1,1,0,14,casualties,1
"Afghanistan: U.N. Reports 'Record-High Levels' of Civilian Casualties
    
In news from Afghanistan the United... http://t.co/YMcZyVKfmE",20,['casualties'],1,1,0,19,casualties,1
Need to stop bottling things up because when everything eventually explodes the casualties just keep getting higher and higher,19,"['stop', 'bottling', 'explodes', 'keep', 'getting']",5,13,12,6,casualties,1
More women children casualties of Afghan violence http://t.co/OstkZA1qaX,10,['casualties'],1,4,3,6,casualties,0
Countless Casualties All Across The Globe War Being Orchestrated On All The Corners Of The Planet [On All Levels] http://t.co/G1BWL3DQQK,24,['Orchestrated'],1,1,0,23,casualties,0
disinfo: Warfighting Robots Could Reduce Civilian Casualties So Calling for a Ban Now Is ... -... http://t.co/yUinMErQ2s #criticalmedia,23,['Is'],1,1,0,22,casualties,0
A poignant reminder that in war there are many casualties. http://t.co/Mwmt3BdR5L,14,['are'],1,10,9,4,casualties,0
There might be casualties tomorrow,5,['be'],1,4,3,1,casualties,1
Memorial day of 70 years Hiroshima and Nagasaki (69 august 1945) wth total casualties 200.000+ . God forgive them!,22,['casualties'],1,16,15,6,casualties,0
Warfighting Robots Could Reduce Civilian Casualties So Calling for a Ban Now Is Premature - http://t.co/trNGqOPBdl,18,"['Warfighting', 'Is']",2,1,0,17,casualties,0
'American Weapons and Support Are Fueling a Bloody Air War in Yemen' http://t.co/7aGeAkVn2x,16,['Fueling'],1,1,0,15,casualties,0
I'M LAUGHING IN THE FACE OF CASUALTIES AND SORROW THE FIRST TIME I'M THINKING PAST TOMORROW BUT I AM NOT THROWIN AWAY MY SHOT,26,"[""'M"", 'LAUGHING', ""'M"", 'AM']",4,1,0,25,casualties,0
@Catwoman1775 Another shooting in a movie theater this is getting more crazier but I'm glad they got the shooter &amp; no casualties.,27,"['is', 'getting', ""'m"", 'got']",4,26,25,1,casualties,0
"Students at Sutherland remember Australian casualties at Lone Pine Gallipoli
 http://t.co/d50oRfXoFB via @theleadernews",16,['remember'],1,6,5,10,casualties,1
Sharp rise in women children casualties in Afghan war UN says http://t.co/0CXm5TkZ8y http://t.co/v5aMDOvHOT,17,['says'],1,6,5,11,casualties,1
@Josh_Daniel_ @mikegiarrusso @FoxNews so do you think a bunch of untrained people firing back isn't going to cause more casualties,24,"['do', 'think', 'firing', 'is', 'going', 'cause']",6,24,23,0,casualties,0
"@FlyOpineMonkey You mean Olympic ;-) 
Also its follow-up for Honshu Operation Coronet. 
In all: 1m Allied casualties 30m Japanese dead.",26,['mean'],1,22,21,4,casualties,1
@AlcoholAndMetal + do anything to fix that. Of the few people he had every trusted in his life Charles was one of the casualties.,27,"['do', 'fix', 'had', 'trusted', 'was']",5,26,25,1,casualties,0
Civilian Casualties in Afghanistan Reach Record High http://t.co/r8pTVFUh5X http://t.co/npCKK0tlEQ,13,['casualties'],1,1,0,12,casualties,1
@CounterMoonbat @Voodoo_Ben I've heard we're still using Purple Hearts manufactured then bc of the # of casualties we expected.,24,"[""'ve"", 'heard', ""'re"", 'using', 'manufactured', 'expected']",6,21,20,3,casualties,0
Another day has passed and THANKFULLY Central Command has CONFIRMED NO new casualties. Please pray for those in... http://t.co/mFSw0tYstA,23,"['has', 'passed', 'has']",3,13,12,10,casualties,1
@JimW_in_NM @KurtSchlichter Here's the thing: they were predicting UP TO A MILLION AMERICAN CASUALTIES. Forget the goddamn Japanese.,24,"[""'s"", 'were', 'predicting', 'Forget']",4,1,0,23,casualties,0
News Wrap: UN warns female and child casualties are on the rise in Afghanistan http://t.co/vSvY1qe69t #pbs #iraq,22,"['warns', 'are']",2,9,8,13,casualties,1
"Revise the Death to America scenario? 

While there's 500 American casualties by Iranian activity SUSPECTED!!! http://t.co/drlKEbeYPi",23,"['Revise', ""'s""]",2,13,12,10,casualties,0
American Weapons and Support Are Fueling a Bloody Air War in Yemen http://t.co/F7ZcqaOcY7,15,['Fueling'],1,1,0,14,casualties,0
#Afghanistan: sharp rise in women and children casualties in first half of #2015 http://t.co/LdyWd4ydT9,19,['casualties'],1,10,9,9,casualties,1
#Civilian casualties in Afghanistan hit highest number since 2009 U.N. says via @WashingtonPost - http://t.co/xTF5DvgRvh,19,"['hit', 'says']",2,3,2,16,casualties,1
@DonteStallworth @SteveSGoddard if you look at the casualties on Iwo Jima and Okinawa and the numbers dead on both sides you'll see it.,27,"['look', 'dead', 'see']",3,10,9,17,casualties,1
@Cameron_Surname @chrisg0000 The Allies forecast an Invasion of Japan had a minimum of 1 million casualties that is a minimum.,23,"['chrisg0000', 'forecast', 'had', 'is']",4,18,17,5,casualties,0
Warfighting Robots Could Reduce Civilian Casualties So Calling for a Ban Now Is Premature http://t.co/lzff4pT4AZ #FTSN #FTSNNewsdesk #├½Ôûê_,23,"['Warfighting', 'Is']",2,1,0,22,casualties,0
@irishspy What you don't think the Allies should have just sucked up 1 million casualties?,18,"['irishspy', 'do', 'think', 'have', 'sucked']",5,17,16,1,casualties,0
Afghanistan: sharp rise in women and children casualties in first half of 2015 http://t.co/3sqSErgnI2,17,['casualties'],1,9,8,8,casualties,1
Train derailment: In Patna no news of any casualty so far http://t.co/Yg697fcQGr,15,['casualty'],1,10,9,5,casualty,1
Property/casualty insurance rates up 1% in July: After several months of no movement commercial property/casu... http://t.co/KcLkoKqI8a,21,['casualty'],1,1,0,20,casualty,0
"#LegalJobs Litigation Attorney in Scottsdale AZ:  Claims Specialist II Casualty Bodily Injury 
The can... http://t.co/zqrQEg3Cxl #Jobs",22,['casualty'],1,1,0,21,casualty,1
Cos sanity brings no reward for one more hit and one last score... Don't be a casualty cut the cord...,23,"['brings', 'Do', 'be']",3,19,18,4,casualty,0
Another sad ocean casualty-Gray whale population in the Pacific listed as critically #endangered (#drone video) https://t.co/vwz3vZpmfb .,23,"['listed', 'endangered']",2,4,3,19,casualty,0
@ThomasHCrown My grandfather was set to be in the first groups of Marines to hit Japan in Operation Olympic. 95% casualty rate predictions,26,"['was', 'set', 'be', 'hit']",4,24,23,2,casualty,0
"├½Ôûê┬ñ@MacCocktail: 'The first casualty of war is truth.'
? Hiram Johnson (died this day) - in Tony Blairs case it died before the war! ??",34,"['is', 'died', 'died']",3,7,6,27,casualty,0
Benzema increasingly looks to be a casualty of Benitez's new look squad. Arsenal bound? 50-50 chance I think,21,"['looks', 'be', 'think']",3,7,6,14,casualty,0
UNPREDICTABLE DISCONNECTED AND SOCIAL CASUALTY ARE MY FAVORITES HOW DO PEOPLE NOT LIKE THEM,14,['casualty'],1,1,0,13,casualty,0
@NorthBayHealth Trauma Center Shines In Response To Multi-Casualty Crash. http://t.co/21B6SKPDUR http://t.co/wBCb3sYtj7,17,['casualty'],1,1,0,16,casualty,1
@ScriptetteSar @katiecool447 btw the 30th is actually next year casualty began 6th September 1986 so 2016 marks 30 years,21,"['btw', 'is', 'began']",3,12,11,9,casualty,0
@AvBronstein @Popehat @instapundit @KurtSchlichter Also are you aware of the casualty estimates for an invasion of Japan's home islands?,25,"['are', 'estimates']",2,15,14,10,casualty,0
Documenting climate change's first major casualty http://t.co/5QMvEwDgiS via @GreenHarvard http://t.co/NmtWI59MU4,16,['Documenting'],1,7,6,9,casualty,0
RT @GreenHarvard: Documenting climate change's first major casualty http://t.co/4q4zd7oU34 via @GreenHarvard,17,['Documenting'],1,11,10,6,casualty,0
@reriellechan HE WAS THE LICH KING'S FIRST CASUALTY BLOCK ME BACK I HATE YOU! http://t.co/0Gidg9U45J,20,"['WAS', 'HATE']",2,1,0,19,casualty,0
Japan had a nuke program (albeit unsuccessful) and the casualty estimates for a ground war were in the tens of millions. @MacKinnon08,26,"['had', 'estimates', 'were']",3,12,11,14,casualty,0
#NowPlaying: Dubstep Hardstyle Trap Messy Mix (event recording) by Alien Casualty on @Mixify http://t.co/m203UL6o7p http://t.co/m203UL6o7p,24,['recording'],1,1,0,23,casualty,0
Small casualty on the way to Colorado http://t.co/hDVmhSQXHm,10,['casualty'],1,2,1,8,casualty,1
.@robdelaney  Catastrophe is anything but! I literally have been unable to stop ejaculating.,17,"['@', 'is', 'have', 'been', 'stop']",5,1,0,16,catastrophe,0
@peterjukes But there are good grounds to believe that 'political military catastrophe' was a crime planned and committed by individuals.,23,"['are', 'believe', 'was', 'planned', 'committed']",5,13,12,10,catastrophe,0
#boy #mix Ultimate #preparedness library: http://t.co/O207JyaByz Prepare Yourself For Any Catastrophe. Over 10 http://t.co/cjCtb2oCxg,23,['catastrophe'],1,1,0,22,catastrophe,0
UPDATE: 7 of the 9 Mac Pros my company bought in May have had catastrophe failures requiring repair!,20,"['bought', 'have', 'had', 'requiring']",4,16,15,4,catastrophe,0
Chances are many of us are still digging out from that catastrophe. THIS is why WoW NEEDS to evolve. THIS is why it can't be Vanilla anymore,30,"['are', 'are', 'digging', 'is', 'evolve', 'is', 'be']",7,12,11,18,catastrophe,0
#nar #phuket Ultimate #preparedness library: http://t.co/qYAeNDvDGC Prepare Yourself For Any Catastrophe. Over http://t.co/3Zp6Ahnsxn,22,['catastrophe'],1,1,0,21,catastrophe,0
bbc r5live studio discussion of hiroshima v poor. sheer *luck* the cold war did not result in catastrophe. MAD = red herring. #ScrapTrident,27,"['did', 'result', 'red']",3,19,18,8,catastrophe,0
Alaska's #Wolves face catastrophe Alexander #ArchipelagoWolves population plummeted 60% in 1 yr. Be their voice:  http://t.co/vCpKdbnSfp,23,"['Wolves', 'plummeted']",2,6,5,17,catastrophe,0
Learning from the Legacy of a Catastrophic Eruption http://t.co/RbmuCURS2F,11,['Learning'],1,1,0,10,catastrophic,0
Following a catastrophic injury acute medical care takes precedent.  PTSD often follows in it's wake undetected... http://t.co/BZkqpl6R0a,22,"['Following', 'takes', 'follows', ""'s""]",4,3,2,19,catastrophic,0
The Catastrophic Effects of Hiroshima and Nagasaki Atomic Bombings Still Being Felt Today http://t.co/oU1M9chznq,16,['catastrophic'],1,1,0,15,catastrophic,0
[WP] Following a catastrophic event the United States is decimated. The President prepares his first post apocaly├½Ôûê_ http://t.co/6eCMRxUyR6,23,"['Following', 'is', 'decimated', 'prepares']",4,6,5,17,catastrophic,0
The Catastrophic Effects of Hiroshima and Nagasaki Atomic Bombings Still Being Felt Today http://t.co/TzxeG4gOkD,16,['catastrophic'],1,1,0,15,catastrophic,0
The Catastrophic Effects of Hiroshima and Nagasaki Atomic Bombings Still Being Felt Today http://t.co/1kRPz3j1EU,16,['catastrophic'],1,1,0,15,catastrophic,0
"'Invading Iraq was a catastrophic mistake'.

Diplomacy needs to replace constant threat of war by US and Israel:

http://t.co/yqjpn3qUUX",24,"[""'Invading"", 'was', 'needs', 'replace']",4,5,4,19,catastrophic,0
Learning from the Legacy of a Catastrophic Eruption http://t.co/25sY9Y295L via @newyorker,14,['Learning'],1,1,0,13,catastrophic,0
The Catastrophic Effects of Hiroshima and Nagasaki Atomic Bombings Still Being Felt Today http://t.co/WC8AqXeDF7,16,['catastrophic'],1,1,0,15,catastrophic,0
Learning from the most destructive volcanic event in U.S. history thirty-five years later: http://t.co/KkjP9KsBst,17,['Learning'],1,1,0,16,catastrophic,0
The Catastrophic Effects of Hiroshima and Nagasaki Atomic Bombings Still Being Felt Today http://t.co/W1iFF7ddvy,16,['catastrophic'],1,1,0,15,catastrophic,0
The Catastrophic Effects of Hiroshima and Nagasaki Atomic Bombings Still Being Felt Today http://t.co/tGcR5voFJ3,16,['catastrophic'],1,1,0,15,catastrophic,0
"Dear @CarlyFiorina Will you or anyone in your family be alive in 2040?

#climatechange #GOPDebate 

 http://t.co/j7Q2ySOMvR

#FeelTheBern",24,['be'],1,1,0,23,catastrophic,0
@APANO55 @JamesMelville 99% of Scientists don├½Ôûê┬¼t believe in Catastrophic Man-Made Global Warming only the deluded do.,20,"['don├½Ôûê┬¼t', 'believe', 'deluded']",3,1,0,19,catastrophic,0
Learning from the Legacy of a Catastrophic Eruption - The New Yorker http://t.co/y8YqPBE4t9,15,['Learning'],1,1,0,14,catastrophic,0
Learning from the Legacy of a Catastrophic Eruption http://t.co/PgXfocgHqg via @newyorker,14,['Learning'],1,1,0,13,catastrophic,0
The Catastrophic Effects of Hiroshima and Nagasaki Atomic Bombings Still Being Felt Today http://t.co/QVlxpyyyCd,16,['catastrophic'],1,1,0,15,catastrophic,0
A better look at what this catastrophic rain and flooding has done to our├½Ôûê_ https://t.co/5yRBegzafX,17,"['has', 'done', 'our├½Ôûê_']",3,7,6,10,catastrophic,0
The Catastrophic Effects of Hiroshima and Nagasaki Atomic Bombings Still Being Felt Today http://t.co/rNqEBAyCVM,16,['catastrophic'],1,1,0,15,catastrophic,0
Learning from the Legacy of a Catastrophic Eruption - The New Yorker http://t.co/t344PhNpy9,15,['Learning'],1,1,0,14,catastrophic,0
Something Catastrophic Is Coming: Should We Tune Out? http://t.co/a8jZ5A26wi,13,"['Something', 'Is', 'Coming', 'Tune']",4,1,0,12,catastrophic,0
'Kessler Syndrome' is the name for the catastrophic exponential proliferation of Space debris and destruction of satellites. #GravityMovie,21,['is'],1,9,8,12,catastrophic,0
@_LalaDeviluke - consequences could have been catastrophic. I was also informed by the security A.I *Mute that you were primarily -,23,"['have', 'been', 'was', 'informed', 'were']",5,8,7,15,catastrophic,0
#gaming Learning from the Legacy of a Catastrophic Eruption: fifteen-mile-high plume of ash . The eruption wh... http://t.co/sv5KBP1FmO,23,"['gaming', 'Learning']",2,1,0,22,catastrophic,0
Learning from the Legacy of a Catastrophic Eruption - The New Yorker http://t.co/vMWTOUyOHm,15,['Learning'],1,1,0,14,catastrophic,0
I suffered a catastrophic pants failure at work today. I resorted to tying my jacket around my waist til I got to a thrift store. #trustory,29,"['suffered', 'resorted', 'tying', 'got']",4,4,3,25,catastrophic,0
Society will collapse by 2040 due to catastrophic food shortages says study http://t.co/2wWZBW5lId,15,"['collapse', 'catastrophic', 'says']",3,8,7,7,catastrophic,0
#Illinois: Emergency units simulate a chemical explosion at NU https://t.co/rd10EX6HvT via @sharethis #hazmat,19,"['simulate', 'sharethis']",2,1,0,18,chemical emergency,1
At FEMA's Center for Disaster Preparedness for a weeklong training on Chemical Biological Radioactive Nuclear   Emergency Response,18,['chemical emergency'],1,1,0,17,chemical emergency,0
Russian nuclear-biological-chemical (NBC) brigade 'emergency response' exercise in Southern MD http://t.co/Ul5XdblmBk http://t.co/VjHpVLnbaw,19,['brigade'],1,1,0,18,chemical emergency,0
???? #Krefeld: the incident happened in a chemical industry park! Emergency operations underway! A building reportly collapsed! @cnnbrk @ntvde,29,"['happened', 'collapsed']",2,1,0,28,chemical emergency,1
USA: BREAKING NEWS: CHEMICAL SPILL/EVACUATIONS/RED CROSS EMERGENCY http://t.co/007Npen6LG,12,['chemical emergency'],1,1,0,11,chemical emergency,1
Emergency crews respond to chemical spill downtown beaumont #benews http://t.co/PME0HOJVYA,13,"['crews', 'spill']",2,1,0,12,chemical emergency,1
Explosion at chemical site leads to building collapse near Krefeld Germany. Emergency crews on scene; avoid the area. #iJETalerts,23,"['leads', 'building', 'crews', 'avoid']",4,1,0,22,chemical emergency,1
"Fake 'explosion toxic chemical' drills emergency responders before Pope Francis 1.5 million visit in Sept.
http://t.co/AjVFJD3qnI",19,['chemical emergency'],1,1,0,18,chemical emergency,0
Emergency crews are on the scene of a chemical spill at Spohn Shoreline. We will have more details as they come to us.,25,"['are', 'have', 'come']",3,1,0,24,chemical emergency,0
Bomb Crash Loot Riot Emergency Pipe Bomb Nuclear Chemical Spill Gas Ricin Leak Violence Drugs Cartel Cocaine Marijuana Heroine Kidnap Bust,21,['chemical emergency'],1,1,0,20,chemical emergency,0
Emergency services called to Bacup after 'strong' chemical smells http://t.co/4GaJhSPfwl,13,['called'],1,1,0,12,chemical emergency,0
Rossendale: Emergency services called to Bacup after 'strong' chemical smells http://t.co/hUDTl2HdSV #rossendale,17,['called'],1,1,0,16,chemical emergency,0
"Emergency services in Hammondville. Near Jewell Close. STORY: http://t.co/jQcy5NwbUg  #Liverpool #7News
https://t.co/snpmAlngvd",21,['chemical emergency'],1,1,0,20,chemical emergency,0
Emergency units simulate a chemical explosion at NU: Suppose a student in the research labs at Northwestern├½Ôûê_ http://t.co/ExitLxgIsJ,21,"['simulate', 'Suppose']",2,1,0,20,chemical emergency,0
Our Chemical Spill Cleanup videos will prepare you for an emergency situation in the lab. http://t.co/UMQbyRUPBd,19,['prepare'],1,1,0,18,chemical emergency,0
Emergency units simulate a chemical explosion at NU - Evanston Now http://t.co/kfyEbhb3DI,14,"['simulate', 'http']",2,1,0,13,chemical emergency,0
Chemical spill at a house in Hammondville. Emergency services attending. #BreakingNews #7News http://t.co/bQ94MjYgfe,19,['attending'],1,1,0,18,chemical emergency,1
@bendwavy emergency chemical rinse,5,['chemical emergency'],1,1,0,4,chemical emergency,0
Emergency 4 Harbor City Mod v4.5.2 #6 Chemical Fire in Residential Area!: http://t.co/uLuPxYzJwV via @YouTube,21,['v4.5.2'],1,1,0,20,chemical emergency,1
Emergency services called to Bacup after 'strong' chemical smells http://t.co/hJJ7EFTJ7O,13,['called'],1,1,0,12,chemical emergency,0
Emergency responders prepare for chemical disaster through Hazmat training. http://t.co/q9zixCi8E6,13,['prepare'],1,1,0,12,chemical emergency,0
"Lindenow: 3:15pm
Emergency crews are at a chemical spill in the main street near Church Street",17,['are'],1,1,0,16,chemical emergency,0
@PMBreedlove Russian nuclear-biological-chemical (NBC) brigade 'emergency response' exercise in Southern MD http://t.co/qyoT2B59ig ├½Ôûê_,19,['brigade'],1,1,0,18,chemical emergency,0
Emergency prompted due to chemical spill at a factory near Redruth├òÔò®UK https://t.co/oiCtAcbwSR http://t.co/46lSIanjMC,17,"['prompted', 'chemical']",2,1,0,16,chemical emergency,1
2Leezy its like you're about to fall down a cliff but you're grabbing my hand but my palms are sweaty ... Why bruh? https://t.co/GrWdr4kuf3,29,"[""'re"", 'fall', ""'re"", 'grabbing', 'are', 'bruh']",6,1,0,28,cliff fall,0
ok peace I hope I fall off a cliff along with my dignity,13,"['hope', 'fall']",2,1,0,12,cliff fall,0
#FunnyNews #Business Watch the moment a cliff collapses as huge chunks of rock fall onto a road in China  http://t.co/LCi3pljX25,24,['collapses'],1,1,0,23,cliff fall,0
Fall off a cliff please  https://t.co/4vWSL2Gfp0,8,['cliff fall'],1,1,0,7,cliff fall,0
Huge cliff landslide on road in China: Watch the moment a cliff collapses as huge chunks of rock fall onto a r... http://t.co/LKDO0momtw,27,"['Watch', 'collapses']",2,1,0,26,cliff fall,1
I accidentally killed an 87 day snap streak and now I wanna accidentally fall off a cliff ????????????????????,38,"['killed', 'snap', 'wan', 'fall']",4,1,0,37,cliff fall,0
"Video: Man rescued after 80ft cliff fall at Shaldon
Read more: http://t.co/efQCLTEVlr http://t.co/4gQy7ziMfC",19,['rescued'],1,1,0,18,cliff fall,0
News Update Huge cliff landslide on road in China - Watch the moment a cliff collapses as huge chunks of rock fall... http://t.co/gaBd0cjmAG,26,"['Watch', 'collapses']",2,1,0,25,cliff fall,1
Huge cliff landslide on road in China: Watch the moment a cliff collapses as huge chunks of rock fall onto a r... http://t.co/eEEwO207mX,27,"['Watch', 'collapses']",2,1,0,26,cliff fall,1
627% but if they had lower striked than 16 I would have gone even further OTM. This could really fall off a cliff.,26,"['had', 'striked', 'have', 'gone', 'fall']",5,1,0,25,cliff fall,0
Runaway Minion Causes Traffic Collapse in Dublin http://t.co/u2Kwof3wtj,10,['collapse'],1,1,0,9,collapse,0
Would a paramedic really do that? Leave someone inside a building that's about to collapse/blow up? @HalloIkBenWill,21,"['do', 'Leave', ""'s"", 'collapse/blow']",4,17,16,4,collapse,0
Watch The Terrifying Moment Two Giant Cranes Collapse Onto Homes: A row of homes was destroyed in seconds. http://t.co/G38Y8H1tJt,23,"['Watch', 'was', 'destroyed']",3,1,0,22,collapse,0
http://t.co/dOg9bw1eCW Correction: Tent Collapse story #HNLnow,10,['collapse'],1,1,0,9,collapse,0
Interview on The Collapse of Materialism Best #TalkRadio Listen Live: http://t.co/sDXZHjco0X,15,['collapse'],1,1,0,14,collapse,0
Economic Collapse Investing: Specific actions and strategies to securing lasting wealth from the financial blowout. http://t.co/JZwRisXEPF,20,"['securing', 'lasting']",2,1,0,19,collapse,0
Correction: Tent Collapse Story http://t.co/CMbNMvVDKl,8,['collapse'],1,1,0,7,collapse,0
We all knew Cain wasn't going to die... It's either Val or someone is gonna collapse later on... #Emmerdale #SummerFate,27,"['knew', 'was', 'going', 'die', ""'s"", 'is', 'gon']",7,20,19,7,collapse,0
EUROCRISIS Guardian Greece's tax revenues collapse as debt crisis continues: As talks continue over proposed ├½├öÔö¼... http://t.co/bBm9sR1wOw,22,"['continues', 'continue', 'proposed']",3,7,6,15,collapse,0
West Side water main break causes street collapse (VIDEO) - El Paso Times http://t.co/uP9TWymJlV,18,['causes'],1,8,7,10,collapse,1
The Guardian Greece's tax revenues collapse as debt crisis continues The Guardian Fresh├½Ôûê_ http://t.co/L0ARQL2q2O,17,['continues'],1,7,6,10,collapse,0
mentions of 'theatre +shooting' on Twitter spike 30min prior to $ckec collapse http://t.co/uuBOvy9GQI,17,"['+shooting', 'ckec']",2,14,13,3,collapse,0
Correction: Tent Collapse Story http://t.co/S7VYGeNJuv,8,['collapse'],1,1,0,7,collapse,0
Residents set up sign as tribute to families who lost their lives in the Thane building collapse: The unfortun...  http://t.co/zT6wANhXuj,24,"['set', 'lost']",2,17,16,7,collapse,1
Correction: Tent Collapse Story http://t.co/jXs50FkviK,8,['collapse'],1,1,0,7,collapse,0
Technical Collapse -&gt;  http://t.co/BfJB5H4tuW     $WLB Down -3.43% to New Low http://t.co/cSXEKREDUg,20,['collapse'],1,1,0,19,collapse,0
Why did I come to work today.. Literally wanna collapse of exhaustion,13,"['did', 'come', 'work', 'wan']",4,11,10,2,collapse,0
#Greece's tax revenues collapse as debt crisis continues via @guardian #bailout http://t.co/cJvbQXw83s ^mp,19,['continues'],1,6,5,13,collapse,0
.@ArneJungjohann #Energiewende is directly responsible for the collapse in energy value. http://t.co/NxvjPj610W,18,['is'],1,11,10,7,collapse,0
#ROH3 #JFB #TFB #alrasyid448ItuRasya Correction: Tent Collapse Story http://t.co/xsnJi8EJRl ROH3 SmantiBatam #ROH3SmantiBatam,20,['collapse'],1,1,0,19,collapse,0
Warne shocked over Australia's epic collapse at Trent Bridge: Johannesburg Aug 06 (ANI): Legendary Australian... http://t.co/LwwoJXtTIV,24,['shocked'],1,1,0,23,bridge collapse,0
Now that's what you call a batting collapse #theashes,11,"[""'s"", 'call']",2,9,8,2,collapse,0
"Greece's tax revenues collapse as debt crisis continues
http://t.co/uxp6PoqjLb",12,['continues'],1,5,4,7,collapse,0
The @POTUS economy continues to collapse.,8,"['continues', 'collapse']",2,7,6,1,collapse,0
I was on my way to Gary but all the Chicago entrances was closed due to a bridge collapsed ?????? I hope they let us through tomorrow,32,"['was', 'was', 'closed', 'collapsed', 'hope', 'let']",6,19,18,13,collapsed,1
35W Memorial honoring those who died when the bridge collapsed. http://t.co/qIb5fYaLGs,14,"['honoring', 'died', 'collapsed']",3,10,9,4,collapsed,0
@organicallyrude @1ROCKSTAR62 #wish Mattingly &amp; Bundy &amp; McGwire were standing on it when it collapsed!,23,"['were', 'standing', 'collapsed']",3,22,21,1,collapsed,0
Roof collapsed a bowling alley many in the community remember going to for more than 30 years @KEZI9 http://t.co/sAhbhLXsSh,22,"['collapsed', 'remember', 'going']",3,2,1,20,collapsed,0
I used to have a good time from June to about July 10th then my summer just collapsed smh,19,"['used', 'have', 'collapsed']",3,18,17,1,collapsed,0
1 hour parade like 50 people collapsed. #OneHeartOneMindOneCSS,10,['collapsed'],1,7,6,3,collapsed,0
... The pain of those seconds must have been awful as her heart burst and her lungs collapsed and there was no air and...,25,"['have', 'been', 'collapsed', 'was']",4,18,17,7,collapsed,0
i remember when i was little and i didnt want to say the pledge and the school collapsed and pit to hell opened,23,"['remember', 'was', 'want', 'say', 'collapsed', 'hell', 'opened']",7,18,17,5,collapsed,0
Bay District coaches learn CPR during medical course: PANAMA CITY ├½Ôûê├ï An athlete collapsed on the field. Coaches... http://t.co/KFkaosh0KH,24,"['learn', 'collapsed']",2,15,14,9,collapsed,1
But the ceiling and the walls collapsed. Upon the darkness I was trapped.,15,"['collapsed', 'was', 'trapped']",3,7,6,8,collapsed,0
@durrellb Prices here are insane. Our dollar has collapsed against the US and it's punishing us. Thanks for the info.,25,"['are', 'has', 'collapsed', ""'s"", 'punishing']",5,11,10,14,collapsed,0
Another entity forced to close in Montego Bay as a result of the collapsed sewer line #TVJNews,18,"['forced', 'close']",2,14,13,4,collapsed,1
VIDEO: Link to the billowing fire after the SouthTowne Lanes roof collapsed: http://t.co/YrRHqZLKoR http://t.co/dXk4sUXMKV,20,['collapsed'],1,13,12,7,collapsed,1
3D view of the storm that developed &amp; collapsed over Albertville this evening; some wind damage reported #valleywx http://t.co/2wJ1MNz3mE,25,"['developed', 'collapsed', 'reported']",3,11,10,14,collapsed,1
Great British Bake Off's back and Dorret's chocolate gateau collapsed - JAN MOIR http://t.co/2SgDOFsmrQ http://t.co/xLEgC6UorA,21,['collapsed'],1,12,11,9,collapsed,0
@JessicaLauraxo grandma collapsed and died,6,"['collapsed', 'died']",2,4,3,2,collapsed,1
3-pronged inquiry launched into collapsed #HongKong furniture retailer DSC http://t.co/Tg3ukIsgEN @scmp_news http://t.co/An5LpimNfA,18,['launched'],1,5,4,13,collapsed,0
@flickershowell oh wow my heart collapsed cool im crying cool cool,12,"['collapsed', 'crying']",2,7,6,5,collapsed,0
Apparently part of the building just collapsed. Hope everyone is ok.,13,"['collapsed', 'is']",2,7,6,6,collapsed,1
@xDescry I was wrong to call it trusty actually.. considering it spontaneously collapsed on me that's not very trusty.,22,"['was', 'call', 'considering', 'collapsed', ""'s""]",5,14,13,8,collapsed,0
Petition | Heartless owner that whipped horse until it collapsed is told he can KEEP his animal! Act Now! http://t.co/87eFCBIczM,24,"['whipped', 'collapsed', 'is', 'told', 'KEEP']",5,10,9,14,collapsed,0
Official: Crowd in tent that collapsed was told to stay put: LANCASTER N.H. - Circus workers first told spectators├½Ôûê_ http://t.co/yRQgASn0JG,24,"['collapsed', 'was', 'told', 'stay', 'put', 'told']",6,7,6,17,collapsed,1
We had a room full of people lifting up Collide in prayer!! We are so excited for Friday night!! http://t.co/645dYNAMy8,26,"['had', 'lifting', 'are']",3,1,0,25,collide,0
@tackettdc Like a scene from When Worlds Collide ......,11,['collide'],1,1,0,10,collide,0
When Houston and NYC collide. ?? @pageparkescorp @chloeunguyen @laurensicle @charstevens97 @tiara_marei #gemma #bowe├½Ôûê_ http://t.co/9wowPs78VD,25,['collide'],1,5,4,20,collide,0
#TheDoolingGroup 2 injured when 2 school buses collide - ├òÔò® #BREAKING: School bus slams into school bus in Bordento... http://t.co/YQHfio9XQm,26,"['injured', 'collide']",2,9,8,17,collide,1
"When transgender Sam takes runaway Lizzie in two very different worlds collide as they explore unjust boundaries and trust.
Sam(uel)
#books",26,"['takes', 'explore']",2,12,11,14,collide,0
Trump &amp; Bill Clinton collide in best conspiracy story ever http://t.co/ABkhBhNLOz via @motherjones TRUMP DEMOCRATIC PLANT?  lmao #lastword,25,['http'],1,7,6,18,collide,0
Police investigating after an e-bike collided with a car in Little Portugal. E-bike rider suffered serious non-life threatening injuries.,21,['suffered'],1,6,5,15,collided,1
#Newswatch: 2 vehicles collided at Lock and Lansdowne Sts in #Ptbo. Emerg crews on their way,20,['collided'],1,6,5,14,collided,1
@FarhanKVirk @PTISalarKhan ! Instead of promoting false news first get your facts right . It was a road rage incident . Vehicles collided,25,"['promoting', 'get', 'was', 'collided']",4,25,24,0,collided,1
I scored 111020 points in PUNCH QUEST stopped when a squeaky bat collided into my skull. http://t.co/aEtgbxm1pL,20,"['scored', 'stopped', 'collided']",3,13,12,7,collided,0
Monsoon flooding - Monsoon rains have have hit India Pakistan and Myanmar hard this season. Two trains collided ... http://t.co/A7zF6N7vrL,23,"['flooding', 'have', 'have', 'hit', 'collided']",5,19,18,4,collided,1
An Eau Claire man who police said was drunk when his SUV collided with a train was sentenced in Chippewa County: http://t.co/kQpkY7Dthj,25,"['police', 'said', 'was', 'collided', 'was', 'sentenced']",6,13,12,12,collided,0
Two trains have collided in India. Please pray for victims their families and rescuers.,16,"['have', 'collided']",2,4,3,12,collided,1
Two cars collided following shotgun fire in Denton http://t.co/0r03C6njLI,11,"['collided', 'following']",2,3,2,8,collided,1
Major accident causes life-threatening injuries closes highway: An 18-wheeler and an SUV collided and then├½Ôûê_ http://t.co/ajTXUafOEM,19,"['causes', 'closes', 'collided']",3,14,13,5,collided,1
'Car vs motorcycle in Harwich Port' HARWICH PORT ├½Ôûê├è A car and motorcycle collided around 5:30 p.m. The crash happen├½Ôûê_ http://t.co/ljxCE1QW2p,25,"['├½Ôûê├è', 'collided']",2,15,14,10,collided,1
The 2 cars right in front of me collided and If I hadnt stopped in time it would've been me too. #ButGod ????,29,"['collided', 'hadnt', 'stopped', ""'ve"", 'been']",5,9,8,20,collided,1
16 dead in Russia bus accident: At least 16 people were killed and 26 others injured when two buses collided i... http://t.co/jMBVPanXR3,26,"['were', 'killed', 'injured', 'collided']",4,21,20,5,collided,1
#maritime The sand carrier Shinto Maru and chemical tanker Hoshin Maru collided on 7 nautical miles off Honshu... http://t.co/2bnfoAGpzD,23,['collided'],1,13,12,10,collided,1
Stupid women nearly collided into me today after she came out of a junction not looking. Still kept coming towards me till I beep my horn,27,"['collided', 'came', 'looking', 'kept', 'coming', 'till', 'beep']",7,4,3,23,collided,0
SSP East says a car AEG 061 driven by a young man collided with Akram's carhot words were exchanged n he did firing in air1bullet hit tyre,28,"['says', 'driven', 'collided', 'were', 'exchanged', 'did', 'firing']",7,13,12,15,collided,1
#Newswatch: 2 vehicles collided at Lock and Lansdowne Sts in #Ptbo. Emerg crews on their way,20,['collided'],1,6,5,14,collided,1
2 pple have been confirmed dead and over 20 rescued while many went missing after a ferry carrying 200 collided with a fishing boat.#News,26,"['have', 'been', 'confirmed', 'went', 'missing', 'carrying', 'collided']",7,20,19,6,collided,1
2 Cars Collide 1 Crashes Into Building: Two cars collided at an intersection and that sent one vehicle crashing├½Ôûê_ http://t.co/TpUu3eaTB3,23,"['collided', 'sent']",2,11,10,12,collided,1
Bicycle-SUV accident in Mesick: Police say that the bicyclist entered onto West M-115 and collided with a boat... http://t.co/A9gtOPyZK8,23,"['say', 'entered', 'collided']",3,16,15,7,collided,1
16 dead in Russia bus accident: At least 16 people were killed and 26 others injured when two buses collided i... http://t.co/ybyP68ieVn,26,"['were', 'killed', 'injured', 'collided']",4,21,20,5,collided,1
Well that was a journey to get home! A train collided with cows on the track! ????,22,"['was', 'get', 'collided']",3,12,11,10,collided,0
Crews working to restore power in southwest Omaha after vehicle collided with utility pole. - http://t.co/dAn0Gkx28l,19,"['working', 'restore', 'collided']",3,11,10,8,collided,1
Stepkans Media - Two confirmed dead after the boat they were travelling in Collided in. L.Victoria http://t.co/INGu6Ztyg4,20,"['confirmed', 'were', 'travelling']",3,1,0,19,collided,1
Cyclist who collided with runner on Roanoke greenway wins $300000 civil verdict - Roanoke Times: Cyclist who c... http://t.co/E2WfGp8JHk,24,"['collided', 'wins', 'c']",3,3,2,21,collided,0
Can't watch PVRIS I'm so sad bc it collided with another set,14,"['watch', ""'m"", 'collided']",3,11,10,3,collided,0
Motorcyclist bicyclist injured in Denver collision on Broadway: At least two people were taken to a local├½Ôûê_ http://t.co/2aCRGdqhJ0,21,"['injured', 'were', 'taken']",3,6,5,15,collision,1
@Zojadelin you literally almost had a head on collision with us today on pilot knob,16,['had'],1,10,9,6,collision,0
Beat:G3 MOTOR VEHICLE COLLISION HIT AND RUN at RAINIER AV S / S CHARLES ST reported on 8/5/2015 6:08 PM Call# 15000270653,25,['reported'],1,1,0,24,collision,1
Beat:B2 MOTOR VEHICLE COLLISION at N 35 ST / FREMONT AV N reported on 8/5/2015 6:52 PM Call# 15000270364,22,['reported'],1,1,0,21,collision,1
Call to car vs fed ex truck head on collision on I-40 mile marker 118. Prayers for the families as we get to the scene!,27,"['Call', 'fed', 'get']",3,10,9,17,collision,1
Motorcyclist bicyclist injured in Denver collision on Broadway http://t.co/eOPWBtUYr9,11,['injured'],1,6,5,5,collision,1
Motorcyclist bicyclist injured in Denver collision on Broadway: At least two people were taken to a local├½Ôûê_ http://t.co/WlmSQ3MTHO,21,"['injured', 'were', 'taken']",3,6,5,15,collision,1
2 dead 2 injured in head-on collision on Kenai Spur Highway http://t.co/hbbGY2vZYt,14,['injured'],1,7,6,7,collision,1
Motorcyclist bicyclist injured in Denver collision on Broadway: At least two people were taken to a local├½Ôûê_ http://t.co/ozK1QHJVfh,21,"['injured', 'were', 'taken']",3,6,5,15,collision,1
Motorcyclist bicyclist injured in Denver collision on Broadway: At least two people were taken to a local├½Ôûê_ http://t.co/PMv8ZDFnmr,21,"['injured', 'were', 'taken']",3,6,5,15,collision,1
The Denver Post - Motorcyclist bicyclist injured in Denver collision on Broadway http://t.co/yjrIi5mHii,15,['injured'],1,10,9,5,collision,1
that collision daaamn,3,['collision'],1,2,1,1,collision,0
On I-405 southbound at Coal Creek Pkwy there is a collision blocking the center lane.,16,"['is', 'blocking']",2,11,10,5,collision,0
Marin Sr37 / Sr121 **Trfc Collision-Unkn Inj** http://t.co/yqJVEVhSzx,10,['collision'],1,1,0,9,collision,0
Westminister Sr22 W / Knott St **Trfc Collision-No Inj** http://t.co/EUmlca1Edw,12,['collision'],1,1,0,11,collision,0
Well Saturn doesn't exist anymore. So the collision place has a starting estimate of $4000. That's 3 times what my car is worth.,29,"['does', 'exist', 'has', 'starting', ""'s"", 'is']",6,10,9,19,collision,0
Riverside I15 N Sr91 E Con / I15 N Sr91 W Con **Trfc Collision-Unkn Inj** http://t.co/QqMLKvgPQk,18,['collision'],1,1,0,17,collision,0
Motorcyclist bicyclist injured in Denver collision on Broadway http://t.co/UpPwxDA4yd,11,['injured'],1,6,5,5,collision,1
West Valley I405 N / Us101 S I405 N Con **Trfc Collision-Unkn Inj** http://t.co/jS9EhP88wQ,16,['collision'],1,1,0,15,collision,0
@MissJadeBrown tells of the tragic mid-morning collision which claimed the life of a young man riding a motorcycle. https://t.co/rPDA60Aoni,23,"['claimed', 'riding']",2,8,7,15,collision,0
Two-vehicle collision at Fowlers Corners at Hwy. 7 and Frank Hill Rd. is blocking the road: OPP. Only minor injuries to the occupants.,28,"['is', 'blocking']",2,2,1,26,collision,1
"my favorite lady came to our volunteer meeting
hopefully joining her youth collision and i am excite http://t.co/Ij0wQ490cS",20,"['came', 'joining', 'am']",3,13,12,7,collision,0
#Colorado #News Motorcyclist bicyclist injured in Denver collision on Broadway: At least two people were tak... http://t.co/2iAFPmqJeP,23,"['injured', 'were']",2,10,9,13,collision,1
7:13pm #MAPLERIDGE Lougheed Hwy EB is closed between 203rd and Dewdney Trunk Rd because of Collision. ETO is between 8:00 PM and 9:00 PM.,27,"['is', 'closed', 'is']",3,1,0,26,collision,1
Traffic Collision - No Injury: I5 S at I5 S 43rd Ave offramp South Sac http://t.co/cT9ejXoLpu,19,['collision'],1,1,0,18,collision,0
CLEARED: COLLISION: #QEW Fort Erie bound approaching Hwy 405 #Niagara.Vehicles removed. ^ag,17,"['approaching', 'removed']",2,1,0,16,collision,0
Motorcyclist bicyclist injured in Denver collision on Broadway http://t.co/ZL7ojdAj3u,11,['injured'],1,6,5,5,collision,1
Motorcyclist bicyclist injured in Denver collision on Broadway: http://t.co/241cN8yxjq by @kierannicholson,15,['injured'],1,6,5,9,collision,1
South Sac I5 S / I5 S 43rd Ave Ofr **Trfc Collision-No Inj** http://t.co/GpxQBYzYu4,16,['collision'],1,1,0,15,collision,0
HTML5 Beginners Crash Course http://t.co/Y32oWBroVF #course http://t.co/Vr2U4cErW8,12,['crash'],1,1,0,11,crash,0
Mom fights to recover in hospital from fiery car crash while kids miss her at home - http://t.co/0UH26R2zfX,20,"['recover', 'miss']",2,10,9,10,crash,1
No citation for Billings police officer who caused Broadwater crash http://t.co/aAhYoEITzl http://t.co/ULZ3ubQV5z,16,['caused'],1,10,9,6,crash,0
'Our little angel': Banjo Pilon 10 dies after skateboarding crash at Wamberal: At the weekend 10-year-old B... http://t.co/5bcOQB6Cff,24,['skateboarding'],1,12,11,12,crash,1
Party for Bestival crash victim Michael Molloy on what would have been his 21st http://t.co/BIkR8zzbhA,17,"['have', 'been']",2,4,3,13,crash,0
CLEARED: Crash in Hamilton on I-75 south at MM 459.,12,['crash'],1,1,0,11,crash,1
Deliver Value: A Cash Source Crash Course http://t.co/st5fGBLsYe #course http://t.co/0uK0H9hOzn,16,['crash'],1,1,0,15,crash,0
Make man pikin crash ??????,10,['crash'],1,4,3,6,crash,0
"#INCIDENT
Crash in Pascoe Vale South outbound on Tullamarine Fwy (CityLink) near Moreland Rd. Vehicles off in emergency lane. No delays.",27,['crash'],1,1,0,26,crash,0
New post: 'India Train Crash Kills Dozens' http://t.co/6OQaZmQa3L,12,['crash'],1,1,0,11,crash,1
Crash and burn ?? https://t.co/Jq2iB1Ob1X,8,['burn'],1,1,0,7,crash,0
@_chelsdelong12 @kendra_leigh13 I'll crash it,8,"['kendra_leigh13', 'crash']",2,7,6,1,crash,0
Thieves crash dealership gate steal four vehicles in Killeen http://t.co/aA47AXC6sr http://t.co/fz5axahPVr,15,"['crash', 'steal']",2,2,1,13,crash,0
#portmoody Clarke Rd hill n/b blocked by crash past Seaview traffic back to Kemsley. Take Como Lake to Gatensbury to get around it.,26,"['blocked', 'Take', 'get']",3,9,8,17,crash,0
'Fatal crash reported on Johns Island' http://t.co/d2i9bL89Zo,10,['reported'],1,2,1,8,crash,1
@natethewolf Car vs Motorcycle Crash Fairport Nine https://t.co/SkUQMJq7g2 #BGC14,13,['crash'],1,1,0,12,crash,0
Police respond to crash find 'suspected heroin' http://t.co/oJoecW29qa,11,['crash'],1,4,3,7,crash,0
AKILAH WORLD NEWS Cop pulls man from car to avoid this ... http://t.co/Vn2Fnmy7li,15,"['pulls', 'avoid']",2,1,0,14,crash,0
Man killed in crash in Barrington Hills: A Hoffman Estates man was killed in a single-car crash Wednesday afte... http://t.co/b6NphxOrZg,24,"['killed', 'was', 'killed']",3,18,17,6,crash,1
NEWS: 2 injured in school bus crash in Bordentown - http://t.co/672bY6OOjn | Details: http://t.co/N5IHOfDpD4,20,['injured'],1,8,7,12,crash,1
Maj Muzzamil Pilot Offr of MI-17 crashed near Mansehra today. http://t.co/kL4R1ccWct,14,['crashed'],1,7,6,7,crashed,1
http://t.co/iGXRqPoTm7 Bin Laden family plane crashed after 'avoiding microlight and landi... http://t.co/3kPBU6hGt5 #PeritoEnGrafoscopia,19,"['crashed', ""'avoiding""]",2,8,7,11,crashed,1
Major Hamayun Shaheed pilot of MI-7 heli that crashed in Mansehra http://t.co/2z8UbsY5M8,14,['crashed'],1,9,8,5,crashed,1
@thomicks Isn't showing up for me. I think it crashed.,14,"['Is', 'showing', 'think', 'crashed']",4,13,12,1,crashed,0
"My iPod crashed..... 
#WeLoveYouLouis 
#MTVHottest One Direction",11,['crashed'],1,3,2,8,crashed,0
Intact+MH370+Part+Lifts+Odds+Plane+Glided+Not+Crashed+Into+Sea http://t.co/MjTN3qbgOS via @YahooFinance#Hope for answers.,12,['crashed'],1,1,0,11,crashed,0
Pak Army Helicopter crashed in Mansehra.,7,['crashed'],1,4,3,3,crashed,1
1 ├½Ôûê├è The bug that almost crashed the Euro - http://t.co/KgkZ50Q8TK,13,['crashed'],1,7,6,6,crashed,0
Pakistan says army helicopter has crashed in country's restive northwest killing at least 8 http://t.co/QV1RMZI3J1,18,"['says', 'has', 'crashed', 'killing']",4,6,5,12,crashed,0
@PahandaBear @Nethaera Yup EU crashed too :P,10,['crashed'],1,7,6,3,crashed,0
This guy bought my car on Tuesday police knocked my door yday cos he crashed n ran &amp; 2day he text me asking not to send the log book????????,39,"['bought', 'knocked', 'cos', 'crashed', 'text', 'asking', 'send']",7,15,14,24,crashed,0
Maj Muzzamil Pilot Offr of MI-17 crashed near Mansehra today. May Almighty give strength to family to bear the loss http://t.co/EI1K01zAb3,24,"['crashed', 'give', 'bear']",3,7,6,17,crashed,0
"aQgcO mhtw4fnet

Pakistan says army helicopter has crashed in country's restive northwest  - Fox News",16,"['says', 'has', 'crashed']",3,8,7,8,crashed,0
Army sources say 12 persons on board including a team of doctors die in helicopter crashed near Mansehra. weather seems to be cause of crash,26,"['say', 'including', 'die', 'crashed', 'seems', 'be']",6,16,15,10,crashed,1
Got a ticket &amp; my car got crashed  man life's great !,15,"['got', 'crashed']",2,10,9,5,crashed,0
"Pak army helicopter crashed in Mansehra. 
Pray for departed souls. http://t.co/XclNBVvfSi",15,['crashed'],1,4,3,11,crashed,1
Website Malfunctioning? PHP Scripts not working? Database Crashed? Need a Unique Script? PHP PRO to the rescue! http://t.co/LadH9Oo086,25,"['working', 'Need']",2,1,0,24,crashed,0
"f496D mhtw4fnet

Pakistan says army helicopter has crashed in country's restive northwest  - Fox News",16,"['says', 'has', 'crashed']",3,8,7,8,crashed,0
Heard #SKH on the radio for the first time. Almost crashed the car. @5SOS @Ashton5SOS @Luke5SOS @Michael5SOS @Calum5SOS,26,['crashed'],1,13,12,13,crashed,0
08 Army personnel including 5 Majors were martyred when a helicopter of Army Medical Corps crashed near Mansehra. http://t.co/wyMrtwsZHU,22,"['including', 'were', 'martyred', 'crashed']",4,16,15,6,crashed,1
MH370: Intact part lifts odds plane glided not crashed into sea http://t.co/8pdnHH6tzH,15,"['lifts', 'glided', 'crashed']",3,10,9,5,crashed,0
The last few days have proven how popular the #BBC is. Over 9m watched Bake Off and iplayer crashed due to cricket commentary.,26,"['have', 'proven', 'is', 'crashed', 'cricket']",5,21,20,5,crashed,0
'@jorrynja: 6. @ your bf/gf/crush ??' @Ter_ell ??,16,['@'],1,1,0,15,crush,0
Ina Buted Girl Crush??,6,['crush'],1,1,0,5,crush,0
Ron &amp; Fez - Dave's High School Crush https://t.co/aN3W16c8F6 via @YouTube,17,['crush'],1,1,0,16,crush,0
sevenfigz has a crush: http://t.co/20B3PnQxMD,8,['has'],1,4,3,4,crush,0
omg I have a huge crush on her because of her looks. ... ├½Ôûê├ï Not necessarily I dont think so! She is looks way be... http://t.co/xqmaTI4GI6,31,"['have', '├½Ôûê├ï', 'dont', 'think', 'is', 'be']",6,6,5,25,crush,0
Man crushed to death by own car http://t.co/CrPO9DkW9v,10,['crushed'],1,2,1,8,crushed,0
A diamond is just a piece of charcoal that handled stress exceptionally well. We are hard pressed on every side but not crushed.2 cor4:8,25,"['is', 'handled', 'are', 'pressed']",4,24,23,1,crushed,0
Holy moly that was crushed.,6,"['was', 'crushed']",2,5,4,1,crushed,0
So many Youtube commenters saying the Dothraki would get crushed if they came to Westeros...nah bro you underestimate the Dothraki,22,"['saying', 'get', 'crushed', 'came', 'Westeros', 'underestimate']",6,10,9,12,crushed,0
@Brandon_Warne MLB has that ball at 462 feet.  Absolutely crushed.,13,"['has', 'crushed']",2,12,11,1,crushed,0
@Spicenthingsup wtf!? I can't. The love bit. I really think that's how she feels. Massive crush that got crushed.,28,"['think', ""'s"", 'feels', 'got', 'crushed']",5,27,26,1,crushed,0
@GhazalaBaji : Exactly!  Curfew like situation when I sit with dad,13,['sit'],1,1,0,12,curfew,0
ARA news reporting JaN fighters infiltrated Ashrafiyah district of Afrin with aim of carrying out suicide attacks. YPG have imposed a curfew,23,"['infiltrated', 'carrying', 'have', 'imposed']",4,23,22,0,curfew,0
Police: Teenagers arrested for curfew violations in Evanston were riding stolen bicycles: Two teenagers taken into cus...  #Chicago #news,24,"['arrested', 'were', 'riding', 'stolen', 'taken']",5,6,5,18,curfew,1
@emmychappy Because it's 12 o'clock and my mom said everyone has to go home because of curfew.,20,"[""'s"", 'said', 'has', 'go']",4,19,18,1,curfew,0
@CurfewBeagle @beaglefreedom Pretty Curfew!!!??,11,['curfew'],1,1,0,10,curfew,0
everybody like fuck curfew.. and i'm sitting here like i'll be in bed by 12.,18,"[""'m"", 'sitting', 'be']",3,4,3,14,curfew,0
@ScotRail i be seen them turn a blind eye to a bloke drinking and smoking on during the curfew time cos'its not worth the hassle',27,"['be', 'seen', 'turn']",3,20,19,7,curfew,0
Next May I'll be free...from school from obligations like family.... Best of all that damn curfew...,22,"['be', 'damn']",2,21,20,1,curfew,0
'The Big Ten has their annual football media day but before we get into that here's some Cyclone hoops recruiting nuggets',23,"['has', 'get', ""'s"", 'recruiting']",4,1,0,22,cyclone,0
An Appeal By Cardinal Charles Bo SDB ( CNUA) Dear Brothers and Sisters The  recent cyclone and the massive... http://t.co/bLgH5bTV8T,24,['cyclone'],1,17,16,7,cyclone,0
Cyclone hits Skye  http://t.co/QZYeRMrQtW http://t.co/N5AI9pQNjg,9,['hits'],1,1,0,8,cyclone,0
"A new tropical cyclone is forming near Guam.

Once it is formed it will be called 'Molave'.",20,"['is', 'forming', 'is', 'formed', 'be', 'called']",6,4,3,16,cyclone,1
"SEVERE WEATHER BULLETIN No. 6
FOR: TYPHOON ├½Ôûê┬ñ#HannaPH├½Ôûê├ÿ (SOUDELOR)
TROPICAL CYCLONE: WARNING

ISSUED AT 11:00 PM... http://t.co/fKoJd0YqK0",27,['cyclone'],1,1,0,26,cyclone,0
First time for everything! @ Coney Island Cyclone https://t.co/SdNT3Dhs3W,12,['cyclone'],1,1,0,11,cyclone,0
@XHNews We need these plants in the pacific during the cyclone seasons it would help,16,"['XHNews', 'need', 'help']",3,12,11,4,cyclone,0
@Aliyeskii @wquddin @tunkhin80 @MaungKyawNu @drkhubybe @nslwin @ibrahimdubashi @mdskar @zarnikyaw @kyawthu043 After cyclone,22,"['wquddin', '@']",2,22,21,0,cyclone,0
BBC Forced To Retract False Claims About Cyclone Pam http://t.co/tbbObvCotj via @wordpressdotcom,15,['cyclone'],1,1,0,14,cyclone,0
GREAT CONDITION Easton Cyclone Softball Bat Fastpitch (-9) 29/20 SK398 http://t.co/rA2mAjPkq2 http://t.co/y7gHHYK05b,18,['cyclone'],1,1,0,17,cyclone,0
"SEVERE WEATHER BULLETIN No. 5
FOR: TYPHOON ├½Ôûê┬ñ#HannaPH├½Ôûê├ÿ (SOUDELOR)
TROPICAL CYCLONE: WARNING

ISSUED AT 5:00 PM 06... http://t.co/qHwE5K7xUW",28,['cyclone'],1,1,0,27,cyclone,0
'The cyclone derives its powers from a calm center. So does a person.' - Norman Vincent Peale,20,"['derives', 'does']",2,2,1,18,cyclone,0
#weather #tropicalweather: Tropical Cyclone Tracking update 1245Z 6 Aug 15. http://t.co/D79laflys9 #tropicalupdate,18,['cyclone'],1,1,0,17,cyclone,0
@roughdeal1 ante hudhud cyclone Chandrababu Valle ne ante Ga?,11,['ante'],1,5,4,6,cyclone,0
Cyclone Komen devastates families in Myanmar this week. We need to help them today: http://t.co/fCujsIOyQO,19,"['devastates', 'need', 'help']",3,1,0,18,cyclone,0
"Back to the future in #Vanuatu how Cyclone Pam has encouraged traditional ways of living:
http://t.co/aFMKcFn1TL http://t.co/6QZXFK2LFS",23,"['has', 'encouraged']",2,1,0,22,cyclone,0
Talent: Misdirection Cyclone Pass Ignite Pass Vanishing Drive Phantom Shot  #KurokoBot,13,['cyclone'],1,1,0,12,cyclone,0
Now on #ComDev #Asia: Radio stations in #Bangladesh broadcasting #programs ?to address the upcoming cyclone #komen http://t.co/iOVr4yMLKp,26,['address'],1,21,20,5,cyclone,0
Is that a hurricane or a typhoon? No matter which one it's also a cyclone. http://t.co/c5kJAtjgzn,21,"['Is', 'one', ""'s""]",3,17,16,4,cyclone,1
Like a cyclone imperialism spins across the globe; militarism crushes peoples and sucks their blood like a... http://t.co/n3VbTC6NCa,22,['spins'],1,3,2,19,cyclone,0
Waige driving like a Badass #ScorpionPilot #Cyclone @ScorpionCBS,11,['driving'],1,1,0,10,cyclone,0
1970 Mercury Cyclone GT Quarter Panel D/S Rear Trim Moulding Cobra Jet 429CJ http://t.co/wqUL8pG5Px http://t.co/4ykXt3kd62,19,['cyclone'],1,1,0,18,cyclone,0
[Tropical Cyclone Info] SOUDELOR 945hPa maximum wind speed: 45m/s maximum wind gust speed: 60m/s  http://t.co/nBD5oT9iEW,21,['cyclone'],1,1,0,20,cyclone,0
"RT  SEVERE WEATHER BULLETIN No. 6
FOR: TYPHOON ├½Ôûê┬ñ├½Ôûê├ÿ (SOUDELOR)
TROPICAL CYCLONE: WARNING

ISSUED AT 11:00 PM...  https://t.co/BYy4dHrqyH",26,['cyclone'],1,1,0,25,cyclone,0
WFP - WFP Delivers Food To 165000 Bangladesh Flood Victims After Tropical Cyclone Komen: DHAKA ├½Ôûê├èThe United Na... http://t.co/fukbBeDfGx,23,['cyclone'],1,1,0,22,cyclone,0
#Rohingya houses in #Kyee NockThie hamlet from Taungbazar region in Buthidaung were severely damaged in Cyclone @KasitaRoch @VivianUNHCR,22,"['were', 'damaged']",2,1,0,21,cyclone,0
FYI: ;ACCIDENT PROPERTY DAMAGE;3460 LIMESTONE LN;COL;YELLOWSTONE WAY;FIELDSTONE DR;08/05/2015 19:36:35,21,['damage'],1,1,0,20,damage,0
Cleared:  Accident with property damage on #NY35 EB at NY 100,13,['Cleared'],1,6,5,7,damage,0
#LM├½Ôûê┬¼s @frauncestavern named one of the historic properties granted $$ by @NYGovCuomo to repair #Sandy damage http://t.co/OcAdC8vFyF,24,"['named', 'granted', 'repair']",3,21,20,3,damage,0
Storm damage reported in West Tennessee http://t.co/90L2lB5WMr,9,['reported'],1,2,1,7,damage,1
Hey the #Royals love doing damage with 2 outs.,11,"['love', 'doing']",2,7,6,4,damage,0
"@Drothvader @CM_Nevalistis you can keep this please!!!!! Arachys
    [2 Pieces] - Now deals 4000% weapon damage (up from 2500%)",32,"['keep', '[', 'deals']",3,26,25,6,damage,0
@BradleyBrad47 yeah but being fast and doing extremely high damage is what its all about if you want fast then im gonna have to get u the-,29,"['being', 'doing', 'is', 'want', 'have', 'get']",6,11,10,18,damage,0
@JoeDawg42 TOR for a TOR situation only. Wind damage enhanced wording is key IMO,16,"['enhanced', 'is']",2,11,10,5,damage,0
@HfxStanfield @beelieveDC @DiscoveryCntr what is happening we hear there is runway lighting damage by a contractor.,20,"['is', 'happening', 'hear', 'is', 'lighting']",5,16,15,4,damage,0
If Trillion crosses the line a 3rd time he does a field-wide attack that does instant kill damage,18,"['crosses', 'does', 'does', 'instant', 'kill']",5,18,17,0,damage,0
Nine inmates charged with causing damage in Calgary Remand Centre riot - http://t.co/1OSmIUXKhW,15,"['inmates', 'charged', 'causing', 'riot']",4,6,5,9,damage,0
#pt Cross-sectarian protest. Powerful Shia cleric says militias must withdraw:'ur fightin ISIS but we wont forget damage uve done to ur ppl',27,"['says', 'withdraw', 'wont', 'done', 'ur']",5,21,20,6,damage,0
Does homeowners insurance cover water damage? Here are some good things to know. http://t.co/0uSDI5JCHo http://t.co/xyg7JhRjoF,21,"['Does', 'are', 'know']",3,6,5,15,damage,0
Beach did damage to my shit,6,['did'],1,3,2,3,damage,0
REPORTED: HIT &amp; RUN-IN ROADWAY-PROPERTY DAMAGE at 15901 STATESVILLE RD,13,['damage'],1,1,0,12,damage,1
#Glaucoma occurs when fluid builds up pressure inside #eye to a level that may damage optic nerve #eyefacts,21,"['occurs', 'builds', 'damage']",3,17,16,4,damage,0
#JSunNews Storm damage reported in Madison County: Thunderstorm damage reports ar... http://t.co/s7NBowa7TP (via http://t.co/3f7owdEcy7),23,['reported'],1,11,10,12,damage,0
Alpine city park vandalized $2500 in damage http://t.co/fwk8puB2wF,11,['vandalized'],1,8,7,3,damage,0
S61.231A Puncture wound without foreign body of left index finger without damage to nail initial encounter #icd10,18,"['wound', 'nail']",2,12,11,6,damage,0
@MichaelWestBiz standard damage control,5,['damage'],1,4,3,1,damage,0
@GettingLost @JennEllensBB @Muncle_jim It said they had superficial wounds and it was the pepper spray that did the most damage.,24,"['said', 'had', 'was', 'did']",4,23,22,1,damage,0
The sign-up is open for the FALLING FOR DANGER release day blast and review tour. Sign-up here:... http://t.co/hbdo22nqPZ,23,"['is', 'review']",2,1,0,22,danger,0
Red Flag Warning for fire danger &amp; dry thunderstorms in Bay Area http://t.co/ugzu9iqPRW #weather #cawx by @NWSBayArea,24,['danger'],1,6,5,18,danger,0
What is this? Like I could be in danger or something,12,"['is', 'be']",2,10,9,2,danger,0
Indian Govt. &amp; Media should take serious concern about their safety. They are in danger now. https://t.co/YX1UKbmTqB,24,"['take', 'are']",2,19,18,5,danger,0
In my post today I talk about the dangers of interruptions. Do they annoy you?http://t.co/zh6AusFbwh,20,"['talk', 'Do', 'annoy']",3,9,8,11,danger,0
@TheElmagoo @GOPTeens @FoxNews @pattonoswalt anyone who actually plays that drinking game is in serious danger of alcohol poisoning,22,"['plays', 'is']",2,19,18,3,danger,0
"@bluebirddenver #FETTILOOTCH IS #SLANGLUCCI OPPRESSIONS GREATEST DANGER COMING SOON THE ALBUM 
https://t.co/moLL5vd8yD",17,['danger'],1,1,0,16,danger,0
SO THIRSTY YALL IN DANGER OF DEHYDRATION,7,['danger'],1,1,0,6,danger,0
Thunderstorms with little rain expected in Central California. High fire danger. #weather #cawx http://t.co/A5GNzbuSqq,20,['expected'],1,12,11,8,danger,1
Honestly tho Modibo Maiga is stealing a living - fuck all about him - im past my best but still more of a danger than that fucktard #coyi,29,"['is', 'stealing']",2,24,23,5,danger,0
@unitedutilities not happy I received text now about #Parasite danger.I am a #transplantee &amp; #Virus can kill #kidney https://t.co/9AasSFrdP1,28,"['received', 'am', 'kill']",3,12,11,16,danger,0
17 dead as Afghanistan aircraft crashes: An Afghan military helicopter has crashed in a remote region of the s...  http://t.co/kI9eHjHl8y,24,"['has', 'crashed']",2,2,1,22,dead,1
dead  https://t.co/ESsxzdTcQJ,4,['dead'],1,1,0,3,dead,0
I just watched emmerdale nd I don't know who most of them are but a slightly attractive man named Ross just got beat up nd now he's dead,30,"['watched', 'do', 'know', 'are', 'named', 'got', ""'s""]",7,30,29,0,dead,0
beforeitsnews : Hundreds feared dead after Libyan migrant boat capsizes during rescue ├½Ôûê_ http://t.co/MjoeeBDLXn) http://t.co/fvEn1ex0PS,20,['feared'],1,5,4,15,dead,1
Perspectives on the Grateful Dead: Critical Writings (Contributions to the Study http://t.co/fmu0fnuMxf http://t.co/AgGRyhVXKr,19,['dead'],1,1,0,18,dead,0
411Naija ├òÔòÜ Flood: Two people dead 60 houses destroyed in Kaduna http://t.co/yAvL49DoOF,15,['destroyed'],1,7,6,8,dead,1
Typhoon Soudelor taking dead aim at Taiwan http://t.co/BhsUxVq6NF,10,['taking'],1,4,3,6,dead,0
Man Found Dead in Demi Moore's Swimming Pool! http://t.co/oCtnPyUEei,13,['Swimming'],1,1,0,12,dead,1
that's it val is dead im suing,8,"[""'s"", 'is', 'suing']",3,6,5,2,dead,0
For everyone that doesn't know Chris Prater was struck by a train this morning and pronounced dead on scene. Prayers to his family.,26,"['does', 'know', 'was', 'struck', 'pronounced']",5,18,17,8,dead,0
Until my death I'll forever rep the Jets.,10,['rep'],1,3,2,7,death,0
@baeffee @RandomPelar the black death (black death whoo!),13,['death'],1,10,9,3,death,0
Adult dies of plague in Colorado http://t.co/yoHVuwuMZS,9,['death'],1,1,0,8,death,1
Going back to Gainesville will be the death of me,10,"['Going', 'be']",2,8,7,2,death,0
http://t.co/lMA39ZRWoY There is a way which seemeth right unto a man but the end thereof are the ways of death.,23,"['is', 'right', 'are']",3,22,21,1,death,0
@KellKane thanks I narrowly averted death that was fun you're right,13,"['averted', 'was', ""'re""]",3,7,6,6,death,0
@Allahsfinest12 ...death to muslims,6,['muslims'],1,4,3,2,death,0
@ITristonTyler CONFESSION when I was little I had a hamster and my room was so cold it froze to death!?? OOPS......,27,"['was', 'had', 'was', 'froze']",4,21,20,6,death,0
The Iran Deal Will Result In Terrorism And Death | Truth Revolt http://t.co/xrG0FacL6T,15,['death'],1,1,0,14,death,0
Ted Cruz Bashes Obama Comparison GOP To Iranians Shouting 'Death To America' http://t.co/tXETcysm1H | #tcot,19,['Shouting'],1,1,0,18,death,0
#Cyprus: News Analysis: Mullah Omar's death may split Taliban's ranks - ..Omar's demise would certainly lead... http://t.co/AJkmcusWHo,26,"['split', 'lead']",2,10,9,16,death,0
A single death is a tradery many deaths is statistics.,11,"['is', 'is']",2,8,7,3,death,0
New: NYC Legionnaires' disease death toll rises http://t.co/NqL21ajmiv #follow (http://t.co/18xQ3FmuGE),19,['rises'],1,7,6,12,death,0
#vaxshill 2 deaths from measles complications in 10 yrs everyone looses their shit. 8 dead from Legionnaires in a month &amp; crickets,26,['looses'],1,4,3,22,deaths,0
don't get on I77 south... huge wreck and airlift and maybe some deaths interstate is completely blocked,19,"['do', 'get', 'interstate', 'is', 'blocked']",5,15,14,4,deaths,1
"├½Ôûê┬ñ@LOLGOP: 2.2 cases of voter fraud a year. 
WE NEED NEW LAWS!

83 gun deaths a day. 
WHO ACTUALLY FOLLOWS LAWS AMIRITE?

#VRA50├½Ôûê├ÿ",31,['ACTUALLY'],1,20,19,11,deaths,0
Silence. #Palermo #Shipwreck #Children #Deaths http://t.co/Tm9ZBHJcyf,13,['deaths'],1,1,0,12,deaths,1
This why BSF Jawans died Fidayeen has AKs and they bloody #INSAS! INSAS rifles not to blame for soldiers' deaths MoD http://t.co/1Lk1EQwyUW,27,"['died', 'has', 'AKs', 'bloody', 'rifles', 'blame']",6,23,22,4,deaths,0
1/2 of the deaths in red-light running crashes are pedestrians bicyclists &amp; other vehicle occupants that are hit by the red-light runners.,25,"['are', 'are', 'hit']",3,4,3,21,deaths,1
@betrayedhunter reading he paused as he came across a couple of deaths and began to read deeper into it.,21,"['paused', 'came', 'began', 'read']",4,13,12,8,deaths,0
500 deaths a year from foodborne illness... @frackfreelancs dears... @DECCgovuk @frackfree_eu @tarleton_sophie http://t.co/JSccX8k0jA,21,['deaths'],1,2,1,19,deaths,0
Bigamist and his 'first' wife are charged in the deaths of his 'second' pregnant wife her child 8 her mother├½Ôûê_ http://t.co/t5HwUnjK7g,25,"['are', 'charged']",2,11,10,14,deaths,0
"[Comment] Deaths of older children: what do the data tell #US? http://t.co/p8Yr2po6Jn
 #nghlth",21,['do'],1,1,0,20,deaths,0
Deaths 7 http://t.co/xRJA0XpL40,5,['deaths'],1,1,0,4,deaths,0
@Eazzy_P we will never know what would have happened but the govt seemed to think that their beliefs warranted the deaths of innocent japs,25,"['know', 'have', 'happened', 'seemed', 'think', 'warranted']",6,22,21,3,deaths,0
"real magic in real life:

women went missing in Ohio town the focus of FBI probe after strange deaths and... http://t.co/6m0YNJWbc9",25,"['went', 'missing']",2,20,19,5,deaths,0
No two cases don't constitute an epidemic. http://t.co/jbLrRNMdsM  #plague #health #publichealth,18,"['do', 'constitute']",2,1,0,17,deaths,0
Weyburn Police Warn Public after Fentanyl Deaths in Province - http://t.co/8bqjtp6iD5 http://t.co/8kjS7ZqAjS,16,['deaths'],1,1,0,15,deaths,1
It's Time To Reduce Gun Deaths http://t.co/ilADQEBxPn,10,"[""'s"", 'Reduce']",2,1,0,9,deaths,0
"Cancers equate for around 25% of all deaths in #Blackpool. 

Kowing the signs could save your life: http://t.co/5lNIdvoBff
#BeClearOnCancer",26,"['equate', 'Kowing', 'save']",3,9,8,17,deaths,0
@mohammedzismail because there was more deaths by regular gunsmissilesbombs and what not warfare than the A-bombs used in A war.,22,"['was', 'used']",2,7,6,15,deaths,0
Infections driving up neonatal deaths ├½Ôûê├è Health Minister #Guyana http://t.co/ImugNXrEBN,13,['driving'],1,5,4,8,deaths,0
@HighQualityBird a reverse situation (lol I don't know 9/11?) where US civilian deaths were specifically utilized to make a political,25,"['do', 'know', 'were', 'make']",4,18,17,7,deaths,0
@mathew_is_angry @Z3KE_SK1 @saladinahmed they died horrible deaths trapped in the ships but they knew that was a risk.,22,"['saladinahmed', 'died', 'trapped', 'knew', 'was']",5,10,9,12,deaths,0
FCO Minister @Tobias_Ellwood condemns attack at a mosque in Saudi Arabia that has resulted in at least 15 deaths http://t.co/c3W95h0ozZ,23,"['condemns', 'has', 'resulted']",3,20,19,3,deaths,0
"Cancers equate for around 25% of all deaths in #Blackpool. 

Kowing the signs could save your life: http://t.co/11dVqjVXPo
#BeClearOnCancer",26,"['equate', 'Kowing', 'save']",3,9,8,17,deaths,0
Bigamist and his ├½Ôûê┬©first├½Ôûê┬¼ wife are charged in the deaths of his ├½Ôûê┬©second├½Ôûê┬¼ pregnant wife her child 8 her mother her nephew 1 and their u├½Ôûê_,26,"['are', 'charged']",2,10,9,16,deaths,0
Critters climate and two plague deaths in Colorado http://t.co/DXkt2Shuj2,11,['climate'],1,6,5,5,deaths,0
MSHA stepping up enforcement after mining deaths: http://t.co/4HM34lrUER via @elkodaily,14,"['stepping', 'mining']",2,7,6,7,deaths,0
Since 1940 the year Angela Sanders was born roundhouse kick related deaths have increased 13000 percent.,17,"['was', 'born', 'related', 'have', 'increased']",5,12,11,5,deaths,0
Bigamist and his 'first' wife are charged in the deaths of his 'second' pregnant wife her child 8 her mothe... http://t.co/RH15gGSgQG,26,"['are', 'charged']",2,11,10,15,deaths,0
As of 2010 there were 17 Beluga deaths reported at #SeaWorld their average age 15 1/2 years #OpSeaWorld http://t.co/MZk5UjlFCV,23,"['were', 'reported']",2,8,7,15,deaths,0
Bigamist and his 'first' wife are charged in the deaths of his 'second' pregnant wife her child 8 her mothe... http://t.co/rTEuGB5Tnv,26,"['are', 'charged']",2,11,10,15,deaths,0
@MayorofLondon pls reduce cyclist deaths with a compulsory highway code test as with EVERY OTHER VEHICLE that uses a road. #notrocketscience,24,"['reduce', 'uses']",2,6,5,18,deaths,0
Is a wing part enough to solve the MH370 mystery?: http://t.co/ys2bveKlxK,15,"['Is', 'solve']",2,1,0,14,debris,0
#aerospace #exec Plane debris is from missing MH370 - Part of the aircraft wing found on Reunion Island is from th... http://t.co/S2wm8lh7oO,27,"['is', 'missing', 'wing', 'found', 'is']",5,6,5,21,debris,1
#?? #?? #??? #??? MH370: Aircraft debris found on La Reunion is from missing Malaysia Airlines ...  http://t.co/MRVXBZywd4,31,"['found', 'is', 'missing']",3,18,17,13,debris,1
Discovered Plane Debris Is From Missing Malaysia Airlines Flight 370 | TIME http://t.co/7fSn1GeWUX,15,"['Is', 'Missing']",2,1,0,14,debris,1
Confirmed the debris from MH370 ??,7,['Confirmed'],1,3,2,4,debris,0
Debris Found in Indian Ocean could be Malaysia Flight 370! http://t.co/VUoJPrKUAX,14,['be'],1,1,0,13,debris,1
Malaysia confirms plane debris washed up on Reunion Island is from Flight MH370 http://t.co/BMxsndx14g,16,"['confirms', 'washed', 'is']",3,4,3,12,debris,0
BBC News - MH370: Reunion debris is from missing Malaysia flight http://t.co/bze47fzKUd,15,"['is', 'missing']",2,7,6,8,debris,1
RÔòá┬«union Debris Is Almost Surely From Flight 370 Officials Say - New York Times http://t.co/gyQLAOz3l2,19,['Is'],1,1,0,18,debris,0
The debris found on Reunion Island was from flight #MH370. The mystery behind that plane disappearance could be better than any novel.,25,"['found', 'was', 'be']",3,2,1,23,debris,1
Investigators: Plane Debris Is 'Conclusively' From MH370 http://t.co/uKOZWID5k3 #gadgets #tech,16,['debris'],1,1,0,15,debris,0
MH370: Aircraft debris found on La Reunion is from missing Malaysia Airlines ... - ABC Onlin... http://t.co/N3lNdJKYo3 G #Malaysia #News,26,"['found', 'is', 'missing']",3,4,3,22,debris,0
Top story: MH370: Reunion debris is from missing plane - BBC News http://t.co/jasWg2MwIi see more http://t.co/qgk64YPN13,22,"['is', 'missing', 'see']",3,7,6,15,debris,0
Per Malaysia's PM 'this piece of debris ... is conclusively a part from the wing of #MH370.' More right now http://t.co/Bd3ik4oz2r,27,"['is', 'http']",2,8,7,19,debris,0
Interesting: MH370: Aircraft debris found on La Reunion is from missing Malaysia Airlines ... - ABC ... http://t.co/950xIJhnVH Please RT,24,"['found', 'is', 'missing']",3,6,5,18,debris,0
Aircraft debris confirmed to be from MH370 - Nation | The Star Online http://t.co/heS0bPU60Y,16,"['confirmed', 'be']",2,2,1,14,debris,0
RT @NLM_DIMRC: A deluge of resources on #floods for medical providers cleanup workers &amp; more at: http://t.co/aUoeyIRqE6,25,['cleanup'],1,6,5,19,deluge,0
Towboat trek sympathy deluge falls: VTc http://t.co/eaaQUMkkc9,10,['falls'],1,4,3,6,deluge,0
Back on the beach after the deluge.  Surf camp in motion.  Our Surf Therapy programme kicked off today for... http://t.co/vjsAqPxngN,25,['kicked'],1,7,6,18,deluge,0
Perhaps 'historic' should be applied not to the deluge of recently exposed #ChildSexAbuse but the truly 'historic' scale of the cover-up,24,"['be', 'applied', 'exposed']",3,10,9,14,deluge,0
If you're in search of powerful content to improve your business or have been frustrated with the deluge of 'quantit├½Ôûê_https://t.co/64cyMG1lTG,23,"[""'re"", 'improve', 'have', 'been', 'frustrated']",5,19,18,4,deluge,0
Here I'm the UK there isn't a deluge of Canadian themed tops around...The timing was perfect. I can't quite believe it. Mad.,30,"[""'m"", 'is', 'themed', 'was', 'quite', 'believe']",6,10,9,20,deluge,0
thousands displaced as houses &amp; roads deluged by floodwater after week of persistent rains. #floods #climate #cdnpoli http://t.co/4WeDZRSWbn,26,"['displaced', 'deluged']",2,9,8,17,deluged,1
Police are still searching for two people after rain and mud deluged the western town of Tetovo├½Ôûê_ http://t.co/XPhZ3GoUhR #Deutsche #Sprache,24,"['are', 'searching', 'deluged']",3,12,11,12,deluged,0
#Glimpses: Hyderabad deluged by heavy rainfall | http://t.co/DctV1uJLHc http://t.co/QOx1jNQSAU,15,['deluged'],1,5,4,10,deluged,1
Why are you deluged with low self-image? Take the quiz: http://t.co/XsPqdOrIqj http://t.co/CQYvFR4UCy,18,"['are', 'deluged', 'Take']",3,4,3,14,deluged,0
Tarp is protecting outfield and cannot be moved. Infield getting deluged.,14,"['is', 'protecting', 'be', 'moved', 'getting', 'deluged']",6,13,12,1,deluged,0
EU states squabble over immigration. UK-France Eurotunnel deluged with migrants. One dead as 'thousands storm' tunnel http://t.co/vf6CKLmCSX,22,"['deluged', 'storm']",2,9,8,13,deluged,0
Businesses are deluged with invoices. Make yours stand out with colour or shape and it's likely to rise to the top of t e pay' pileq,29,"['are', 'deluged', ""'s"", 'rise']",4,3,2,26,deluged,0
Glimpses: &lt;b&gt;Hyderabad&lt;/b&gt; deluged by heavy rainfall: HYDERABAD: With flood waters heading├½Ôûê_ http://t.co/TWFWTxZ2dS,31,"['deluged', 'heading├½Ôûê_']",2,18,17,13,deluged,1
News Alerts - Glimpses: Hyderabad deluged by heavy rainfall,10,"['Glimpses', 'deluged']",2,7,6,3,deluged,0
They've come back!! &gt;&gt; Flying ant day: Capital deluged by annual swarm of winged insects http://t.co/mNkoYZ76Cp,27,"[""'ve"", 'come', 'Flying', 'deluged']",4,18,17,9,deluged,0
Rand Paul's Debate Strategy 'demolish Some other bad ideas out there or point out maybe that there are some em... http://t.co/qzdqRBr4Lh,25,"['point', 'are']",2,1,0,24,demolish,0
"RT AbbsWinston: #Zionist #Terrorist Demolish Tire Repair Shop Structure in #Bethlehem
http://t.co/Om3ntQIh2m http://t.co/6SAS3fuahA",21,['demolish'],1,1,0,20,demolish,0
Salvation Army bid to demolish cottages http://t.co/3kuXonOchl #Southend http://t.co/enQaSCGFyw,14,"['demolish', 'http']",2,5,4,9,demolish,0
Enugu Government to demolish illegal structures at International Conference Centre http://t.co/ouYLwuIXcs,13,['demolish'],1,4,3,9,demolish,0
"RT AbbsWinston: #Zionist #Terrorist demolish 18 #Palestinian structures in Jordan Valley http://t.co/rg3BndKXjX
├½Ôûê_ http://t.co/Bq90pfzMrP",22,['demolish'],1,8,7,14,demolish,1
The far right racist #AvigdorLiberman calls for destruction of #Susiya ! Previously he also called for beheadings!   http://t.co/Li8otXt8hh,23,"['calls', 'called']",2,1,0,22,demolish,0
No Shane I'm sorry you are wrong. You were propagating that an all out attack would demolish England #reversal,22,"[""'m"", 'are', 'were', 'propagating', 'demolish']",5,19,18,3,demolish,0
If you think going to demolish Drake's house over some ghostwriting shit you should know that Rihanna lives next door.,22,"['think', 'going', 'demolish', 'ghostwriting', 'know', 'lives']",6,6,5,16,demolish,0
A demolished Palestinian village comes back to life http://t.co/Jsf5OFB3m6 via @wagingnv http://t.co/Hskd5MUosM,17,"['comes', 'wagingnv']",2,2,1,15,demolished,0
It was finally demolished in the spring of 2013 and the property has sat vacant since. The just├½Ôûê_: saddlebrooke... http://t.co/7FOnHQtlyv,25,"['was', 'demolished', 'has', 'sat']",4,4,3,21,demolished,0
Got my first gamer troll I just demolished a kid from Philly with Toronto on MLB and he was upset #BacktoBack #ChargedUp ??????,30,"['demolished', 'was']",2,8,7,22,demolished,0
Why is CHURCH media and #Media420 silent when #PapiCongress has demolished the house of a journo in UK @pragnik,22,"['is', 'has', 'demolished']",3,13,12,9,demolished,0
@Ramdog1980 Israeli soldiers demolished a residential shed and a barn. Soldiers also demolished a shed in Beit Kahel northwest of Hebron.,24,"['demolished', 'demolished', 'shed']",3,15,14,9,demolished,0
Six Palestinians Kidnapped in West Bank Hebron Home Demolished - International Middle East Media Center http://t.co/J9UzIIQ3PX,18,['Kidnapped'],1,1,0,17,demolished,0
Uttarakhand: Journalist's house demolished who exposed corruption - Oneindia http://t.co/Ro1aWWuDYE,14,"['demolished', 'exposed']",2,6,5,8,demolished,0
├½Ôûê┬ñ@SplottDave: @TeamPalestina That's about 28700 Palestinian homes demolished now by Israel since 1967 w/ 0 Israeli home demolished @POTUS,25,"['SplottDave', ""'s"", 'demolished', 'demolished']",4,23,22,2,demolished,0
#BBSNews latest 4 #Palestine &amp; #Israel -  Six Palestinians Kidnapped in West Bank Hebron Home Demolished http://t.co/gne1fW0XHE,24,['demolished'],1,1,0,23,demolished,0
@stallion150 @kbeastx they totally demolished genisys which was a beautiful film and almost 90% of the people agreed,21,"['kbeastx', 'demolished', 'was', 'agreed']",4,7,6,14,demolished,0
A demolished Palestinian village comes back to life http://t.co/9Lpf4V4hMq,11,['comes'],1,2,1,9,demolished,0
Real-life 'Up' house set to be saved from demolition by charity http://t.co/rdD5Fe1qyJ,15,"['set', 'be', 'saved']",3,10,9,5,demolition,0
EPA begins demolition of homes in toxic area #Buffalo - http://t.co/noRkXBRS6G,14,['begins'],1,3,2,11,demolition,0
De-watering demolition defends against flooding http://t.co/dTO0ULjxn3,8,['flooding'],1,2,1,6,demolition,0
"#Muslim cemetery demolition infuriates cultural groups in #Israel 

http://t.co/vpLZKUidz2",13,['infuriates'],1,4,3,9,demolition,0
Saving the City in Old Town: The Proposed Demolition of 159 West Burton http://t.co/FJddx43Ewj @MessnerMatthew for @newcity,22,"['Saving', 'Proposed']",2,1,0,21,demolition,0
No civilian population ever deserves demolition may we never forget &amp; learn from our mistakes #Hiroshima,19,"['deserves', 'forget', 'amp']",3,6,5,13,demolition,0
#download &amp; #watch Demolition Frog (2002) http://t.co/81nEizeknm #movie,17,['demolition'],1,1,0,16,demolition,0
Demolition Means Progress: Flint Michigan and the Fate of the American Metropolis Highsmith https://t.co/ZvoBMDxHGP,17,['demolition'],1,1,0,16,demolition,0
General News ├½Ôûê├│├òÔò®'Demolition of houses on waterways begins at Achimota Mile 7 ' via @233liveOnline. Full story at http://t.co/iO7kUUg1uq,23,['demolition'],1,1,0,22,demolition,0
Delmont's 'Onion House' Purchased After Plans For Demolition http://t.co/yojKfQeJ6s,13,['Purchased'],1,1,0,12,demolition,0
Demolition Means Progress: Flint Michigan and the Fate of the American Metropolis Highsmith https://t.co/fj7p8A1hvM,17,['demolition'],1,1,0,16,demolition,0
Israel continues its demolition of Palestinian homes #gop #potus #irandeal #isis  https://t.co/NMgp7iMEIi,18,['continues'],1,4,3,14,demolition,0
@Johnny_Detroit Tag Team for me was Demolition.  Awesome intro song scary looking and just destroyed there opponents.,20,"['was', 'looking', 'destroyed']",3,1,0,19,demolition,0
"Kaduna Begins Demolition Of Buildings On Govt School Lands
http://t.co/77cIWXABVA├½Ôûê_t-school-lands/",12,['demolition'],1,1,0,11,demolition,0
Photo: mothernaturenetwork: Seattle├½Ôûê┬¼s demolition-dodging ├½Ôûê┬©Up├½Ôûê┬¼ house to live on as affordable housing But... http://t.co/szG0HsNJEw,19,['live'],1,6,5,13,demolition,0
Seven Chinese Christians Are Detained Amid Widespread Anger Over Cross Demolition http://t.co/65xR1p9sOO,14,"['Are', 'Detained']",2,1,0,13,demolition,0
Here├½Ôûê┬¼s what caused a Metro train to derail in downtown D.C. http://t.co/ImTYgdS5qO,14,"['caused', 'derail']",2,8,7,6,derail,1
@ALESHABELL GM! I pray any attack of the enemy 2 derail ur destiny is blocked by the Lord &amp; that He floods ur life w/heavenly Blessings,30,"['pray', 'is', 'blocked', 'floods']",4,13,12,17,derail,0
BBC News - India rail crash: Trains derail in Madhya Pradesh flash flood http://t.co/WgmZmJ5imD,17,['derail'],1,9,8,8,derail,1
Dr. Gridlock: Here├½Ôûê┬¼s what may have caused a Metro train to derail in downtown D.C. http://t.co/Pm2TNnFDWw #washingtonpost,22,"['have', 'caused', 'derail']",3,14,13,8,derail,1
@TemecaFreeman GM! I pray any attack of the enemy 2 derail ur destiny is blocked by the Lord &amp; that He floods ur life w/heavenly Blessings,30,"['pray', 'is', 'blocked', 'floods']",4,13,12,17,derail,0
24 killed in two simultaneous rail crash as acute floods derail the two trains #India #mumbai... http://t.co/4KBWPCmMbM,22,"['killed', 'derail']",2,11,10,11,derail,1
Two trains derail in central India's Madhya Pradesh http://t.co/ijDePwuYNY,12,['derail'],1,3,2,9,derail,1
BBC News - India rail crash: Trains derail in Madhya Pradesh flash flood http://t.co/fU1Btuq1Et,17,['derail'],1,9,8,8,derail,1
Will @FoxNews continue to derail the Iran Nuclear Deal during tonight's #GOPDebate  oh yeah.,18,"['@', 'continue', 'derail', 'yeah']",4,6,5,12,derail,0
BBC News - India rail crash: Trains derail in Madhya Pradesh flash flood http://t.co/9UFemKfIiv,17,['derail'],1,9,8,8,derail,1
Lake Dallas crash causes train to derail http://t.co/ao4Ju9vMMF,10,"['train', 'derail']",2,7,6,3,derail,1
Related News: Here&amp;#8217;s what caused a Metro train to derail in downtown D.C. - Local - The Washington Post |  http://t.co/4AoNQ9vnhs,31,"['Related', 'amp', 's', 'caused', 'derail']",5,18,17,13,derail,0
How do you derail a train at... Smithsonian?,10,"['do', 'derail']",2,4,3,6,derail,0
BBC News - India rail crash: Trains derail in Madhya Pradesh flash flood http://t.co/wmUTCDG36b,17,['derail'],1,9,8,8,derail,1
25 killed as Kamayani Express Janata Express derail in Madhya Pradesh; ex gratia announced http://t.co/6SDTzSgElq,18,"['killed', 'announced']",2,8,7,10,derail,1
Dozens dead as two trains derail over river in India http://t.co/zkKn6mSE1n http://t.co/FzHJF8BXlD,16,['derail'],1,6,5,10,derail,1
24 killed in two simultaneous rail crash as acute floods derail the two trains #India #mumbai... http://t.co/b0ZwI0qPTU,22,"['killed', 'derail']",2,11,10,11,derail,1
India floods derail two trains killing 21 people  http://t.co/2Fs649QdWX,11,"['derail', 'killing']",2,3,2,8,derail,1
BCC: Premature interest rates increases could derail the recovery: Commentating on today├½Ôûê┬¼s interest rate decis... http://t.co/aftpebIkbO,21,['derail'],1,8,7,13,derail,0
Dozens Die As two Trains Derail Into A River In Indiahttp://www.informationng.com/?p=309943,15,['derail'],1,1,0,14,derail,1
Sound judgement by MPC - premature rises could derail recovery #Business http://t.co/fvLgU1naYr,15,['derail'],1,9,8,6,derail,0
@CoolBreezeT train derailed at Smithsonian...no passenger train...then my red line train became disabled between FH &amp; Bethesda,24,"['derailed', 'became']",2,4,3,20,derailed,0
@Ohmygoshi @unsuckdcmetro At this point I expect to hear reports about a Metrobus being derailed.,18,"['expect', 'hear', 'being', 'derailed']",4,17,16,1,derailed,0
Interesting to note: Metro train derailed in Washington this morn after going thru interlocking area. One of lines affected by closure 1/3,24,"['Interesting', 'note', 'derailed', 'going', 'interlocking', 'affected']",6,7,6,17,derailed,1
@FixWMATA @AdamTuss Do you know about path of derailed train? Doesn't make sense. If it was coming from yard why turning at Smithsonian?,29,"['know', 'Does', 'make', 'was', 'coming']",5,11,10,18,derailed,0
Train derailed at Smithsonian Metro. Sidewalks outside L'Enfant mobbed to get on buses @wmata #nightmarecommute,18,"['derailed', 'mobbed', 'get']",3,2,1,16,derailed,1
Happy no one was hurt when #wmata train derailed. Also the express bus is so much better than metro rail http://t.co/7cEhNV3DKy @fox5newsdc,27,"['was', 'hurt', 'derailed', 'is']",4,10,9,17,derailed,1
@lizkhalifa no passenger train derailed earlier this morning,9,"['lizkhalifa', 'derailed']",2,6,5,3,derailed,0
DC Media: tip for getting updates on the derailed #WMATA train today - ask them about movie night and quickly change the subject!,26,"['getting', 'ask', 'change']",3,10,9,16,derailed,0
@jozerphine LITERALLY JUST LOOK THAT UP! YEAH DERAILED AT SMITHSONIAN SO EVERYTHIGN IS SHUT DOWN FROM FEDERAL CENTER SW TO MCPHERSON,23,['derailed'],1,1,0,22,derailed,1
@TrustyMcLusty no passengers were on the derailed train. But the who morning commute is fcked. Go home.,21,"['were', 'is', 'fcked']",3,8,7,13,derailed,0
The crocodile tears don't wash with me she's more upset that the gravy train has been derailed #kidscompany http://t.co/BCPmVylSih,24,"['do', 'wash', ""'s"", 'has', 'been', 'derailed']",6,19,18,5,derailed,0
".@CBCNorth see photo Old Lady of the Falls (sacred site) RR says derailed Talston power line to diamond mines in 2010
http://t.co/SxlfSNsPH0",28,"['see', 'says', 'derailed', 'diamond']",4,17,16,11,derailed,0
@Epic_Insanity It got derailed outside Grimrail Depot...,9,['got'],1,5,4,4,derailed,0
[UPDATE] No-Passenger Metro Train Derails Causing Terrible Delays This Morning: A derailed train is causing a hell├½Ôûê_ http://t.co/bLCBAbM7A1,23,"['Delays', 'is', 'causing']",3,15,14,8,derailed,1
@stury Note there were no passengers on board when the train derailed this morning.,16,"['were', 'derailed']",2,13,12,3,derailed,0
Whoa a #wmata train derailed at Smithsonian?,9,['derailed'],1,6,5,3,derailed,0
Metro acting chief Jack Requa says train that derailed was a six-car train with 1000 and 2000 series rail cars. #wmata,23,"['acting', 'says', 'derailed', 'was']",4,9,8,14,derailed,0
#Metro still doesn't know when Blue &amp; Orange lines will reopen. Empty passenger car derailed ~ 5 a.m. NOT a new 7000-series. @CQnow #WMATA,32,"['does', 'know', 'reopen', 'derailed', '@']",5,20,19,12,derailed,0
Breakfast links: Work from home: Derailed: An empty train derailed at Smithsonian this morning suspending ser... http://t.co/iD4QGqDnJQ,23,"['Derailed', 'derailed', 'suspending']",3,13,12,10,derailed,1
On the eve of Jon Stewart leaving The Daily Show WMATA has honored him by letting another train get derailed and crippling the service.,25,"['leaving', 'has', 'honored', 'letting', 'derailed', 'crippling']",6,20,19,5,derailed,0
Going to starbs it's only 70 degrees part of the metro derailed it's a beautiful morning in Washington D.C.,22,"['Going', 'starbs', ""'s"", 'derailed', ""'s""]",5,13,12,9,derailed,0
@AdamTuss and is the car that derailed a 5000 series by chance. They used to have issues w/ wheel climbing RE: 1/2007 Mt. Vern Sq derailment,30,"['is', 'derailed', 'used', 'have', 'w/', 'climbing']",6,8,7,22,derailed,1
So a train derailed and instead of me getting to work early like I would've I'm now late as fuck,22,"['derailed', 'getting', 'work', ""'ve"", ""'m""]",5,4,3,18,derailed,0
Relief train carrying survivors of the derailed Janta Express reaches Mumbai via @firstpostin http://t.co/CZNXHuTASX,17,"['carrying', 'reaches']",2,7,6,10,derailed,0
How many trains derailed that @wmata has to shut down orange/blue in most of DC? The Avengers made less of a mess @unsuckdcmetro,26,"['derailed', 'has', 'shut', 'made']",4,4,3,22,derailed,0
Also there is no estimate of damage yet from #WMATA/#Metro on the six-car train that derailed ~5 a.m. Shuttle service available. @CQnow,28,"['is', 'derailed']",2,19,18,9,derailed,0
1 of those days when ya don't realize till already in transit that a train DERAILED at the Metro St closest to work?? https://t.co/QYX5ThkRbH,29,"['do', 'realize', 'till', 'work']",4,1,0,28,derailed,0
Oh a #wmata train derailed. Kind of disappointed how unsurprised I am.,15,"['derailed', 'am']",2,6,5,9,derailed,0
.@unsuckdcmetro Is the train half-derailed or half-railed? #deepthoughts,12,['Is'],1,1,0,11,derailed,0
Sad that biker beatdown derailed his pro-democracy work as @NYPDnews undercover: http://t.co/iHHRKG4V1S. http://t.co/aryU5qNgJJ,20,"['biker', 'derailed']",2,5,4,15,derailed,0
3 cars of #Metro train ready to go into service derailed near #Smithsonian station disrupting service. No injuries. More at noon @wusa9,27,"['train', 'go', 'derailed', 'disrupting']",4,12,11,15,derailed,0
@ItsQueenBaby I'm at work it's a bunch of ppl and buses because the train derailed,18,"[""'m"", ""'s"", 'derailed']",3,18,17,0,derailed,0
"CNN News August 5 2015 Two trains derailed amid floods ...
Video for india august flooding 2015 video youtube?... http://t.co/MMIyE1k8ZZ",24,['derailed'],1,8,7,16,derailed,1
@GerryConnolly @RepDonBeyer @timkaine Today's #Metro commute debacle w/derailed non-passenger train shows clearly we need a Rail MGR CEO!,24,"['w/derailed', 'need']",2,1,0,23,derailed,0
@OhYayyyYay the train derailed this morning,7,['derailed'],1,5,4,2,derailed,0
Madhya Pradesh Train Derailment: Village Youth Saved Many Lives,10,['Saved'],1,1,0,9,derailment,0
Service on the Green Line has resumed after an earlier derailment near Garfield with residual delays.,17,"['has', 'resumed']",2,11,10,6,derailment,0
Death on Railway track: Why rains cannot take all the blame?: Derailment is not very common. Last year less th... http://t.co/jdkQC12tid,29,"['take', 'is']",2,1,0,28,derailment,0
Google News - A Twin Train Derailment in India Leaves at Least 24 Dead - TIME http://t.co/yf56oK7Pgp #world,21,['derailment'],1,1,0,20,derailment,1
#news Madhya Pradesh Train Derailment: Village Youth Saved Many Lives http://t.co/fcTrAWJcYL #til_now #NDTV,19,['Saved'],1,1,0,18,derailment,0
"MP trains derailment: ├½Ôûê┬©It├½Ôûê┬¼s the freakiest of freak accidents├½Ôûê┬¼: 

MP trains derailment: ├½Ôûê┬©It├½Ôûê┬¼s the freakiest of ... http://t.co/uHXODSc7Wi",23,"['trains', '├½Ôûê┬©It├½Ôûê┬¼s', 'trains', '├½Ôûê┬©It├½Ôûê┬¼s']",4,14,13,9,derailment,0
#TeamFollowBack Madhya Pradesh Train Derailment: Village Youth Saved Many Lives  #FollowBack,14,['Saved'],1,1,0,13,derailment,0
@CTAFails PHOTOS from Green Line derailment http://t.co/Y8xFVJAlLr http://t.co/qUUUN88czw,13,['derailment'],1,7,6,6,derailment,0
#ModiMinistry Madhya Pradesh Train Derailment: Village Youth Saved Many Lives http://t.co/YvMpHd0z9X,15,['Saved'],1,1,0,14,derailment,1
Still and Box alarm for the train derailment at 61st and Calumet struck out on the orders of 2-1-21. #ChicagoScanner,22,['struck'],1,8,7,14,derailment,0
Consent Order on cleanup underway at CSX derailment site - Knoxville News Sentinel http://t.co/GieSoMgWTR http://t.co/NMFsgKf1Za,19,['derailment'],1,8,7,11,derailment,0
Madhya Pradesh Train Derailment: Village Youth Saved Many Lives: A group of villagers saved over 70 passengers' lives after two train...,25,"['Saved', 'saved']",2,1,0,24,derailment,0
#CTA GREEN LINE: All passengers have been evacuated due to a derailment however no service Garfield-Cottage Grove. http://t.co/qePJ0Hwpay,23,"['have', 'been', 'evacuated']",3,14,13,9,derailment,1
"CHICAGO FD
STILL &amp; BOX ALARM/EMS PLAN I 
 61ST &amp; CALUMET FOR THE EL TRAIN DERAILMENT
CINS/TG",21,['derailment'],1,1,0,20,derailment,0
@Raishimi33 :) well I think that sounds like a fine plan where little derailment is possible so I applaud you :),24,"['well', 'think', 'sounds', 'is', 'applaud']",5,16,15,8,derailment,0
Railway Minister Prabhu calls MP derailment a natural calamity http://t.co/ocxBWGyFT8,12,['calls'],1,6,5,6,derailment,0
Latest : Trains derailment: 'It's the freakiest of freak accidents' - The Indian Express: The Indi... http://t.co/iLdbeJe225 #IndianNews,26,['derailment'],1,4,3,22,derailment,0
@AlvinNelson07 A train isn't made to withstand collisions! Immediate derailment. It's totally fucked.,19,"['is', 'made', 'withstand', ""'s"", 'fucked']",5,13,12,6,derailment,0
Suresh Prabhu calls Harda derailment a natural calamity; officials feel warning signs ignored: Prabhu may regr... http://t.co/Q5MlbODVm4,22,"['calls', 'feel', 'warning', 'ignored', 'regr']",5,5,4,17,derailment,0
25 killed 50 injured in Madhya Pradesh twin train derailment http://t.co/DNU5HWSxo2,13,"['killed', 'injured']",2,10,9,3,derailment,1
Mumbai24x7 Helping Hand: In Mumbai 2 TTEs take charge of helpline to calm anxious relatives - The Ind... http://t.co/tUARYIJpqU #Mumbai,25,"['take', 'calm']",2,1,0,24,derailment,0
PHOTOS: Green Line derailment near Cottage Grove and Garfield: http://t.co/4d9Cd4mnVh http://t.co/UNhqCQ6Bex,17,['derailment'],1,5,4,12,derailment,0
Train derailment: In Patna no news of any casualty so far - The Indian Express http://t.co/YH5VETm0YZ http://t.co/17Wgug8z0M,22,['derailment'],1,2,1,20,derailment,0
After the green line derailment my concern for track that looks like this goes up a bit... @cta @CTAFails http://t.co/1uDz0NVOEH,25,"['looks', 'goes']",2,5,4,20,derailment,0
Very sad to learn of the derailment of 2 trains in Mp.My deepest condolences to the families who lost loved ones in this Mishap @OfficeOfRG,26,"['learn', 'lost']",2,7,6,19,derailment,1
Green Line trains resume service after South Side derailment: Green Line service has resumed more than four h... http://t.co/dJztc7apf1,23,"['resume', 'has', 'resumed']",3,9,8,14,derailment,0
Madhya Pradesh Train Derailment: Village Youth Saved Many Lives: A group of villagers saved over 70 passengers' lives after two train...,25,"['Saved', 'saved']",2,1,0,24,derailment,0
#Amtrak Rail #Disaster http://t.co/H6Ol73KZJg http://t.co/Qfydu4PVGK,11,['derailment'],1,1,0,10,derailment,0
Scene of the derailment.. CTA Green Line at 63rd/Prairie http://t.co/zz5UDiLrea,12,['derailment'],1,4,3,8,derailment,1
Consent Order on cleanup underway at CSX derailment site - Knoxville News Sentinel http://t.co/xsZx9MWXYp http://t.co/NMFsgKf1Za,19,['derailment'],1,8,7,11,derailment,0
Thanks a lot roadworks men cos a tube strike wasn't disruptive enough so having to walk the desolate route from Tottenham to .....,25,"['roadworks', 'cos', 'was', 'having', 'walk', '..']",6,19,18,6,desolate,0
Me watching Law &amp; Order (IB: @sauldale305) (Vine by @NaturalExample) https://t.co/tl29LnU44O,22,['watching'],1,1,0,21,desolate,0
I totally agree. They rape kill destroy and leave land desolate. Action needs to happen before the swarm swells. https://t.co/Twcds433YI,25,"['agree', 'rape', 'kill', 'needs', 'happen']",5,12,11,13,desolate,0
And the 10 horns which u saw on the beast these will hate the harlet make her desolate and naked eat her flesh and burn her with fire,28,"['u', 'hate', 'make', 'burn']",4,18,17,10,desolate,0
Unexercised honda run-down neighborhood desolate: PSqD,7,['Unexercised'],1,5,4,2,desolate,0
@WilliamTCooper TY for the follow Go To http://t.co/l9MB2j5pXg BRUTALLY ABUSED+DESOLATE&amp;LOST + HER LOVELY MUM DIES..Is it Murder? Pls RT,27,"['http', '//t.co/l9MB2j5pXg', '+']",3,1,0,26,desolate,0
@Bill_Roose That looks so desolate and just...depressing,10,"['looks', 'depressing']",2,6,5,4,desolate,0
@CorleoneDaBoss bc its risky and costly I don't see a need to do that when there isn't anything there. It's totally desolate.,28,"['do', 'see', 'do', 'is', ""'s""]",5,27,26,1,desolate,0
? This Weekend: Stockholm Sweden - Aug 8 at Copperfields http://t.co/6un7xC9Sve,14,['desolation'],1,1,0,13,desolation,0
desolation #bored,3,['bored'],1,1,0,2,desolation,0
The date for the release of EP03 DESOLATION is set. Stay tuned for more info while we finalise the schedule. #alt #electro #rock #comingsoon,30,"['is', 'set', 'tuned', 'finalise']",4,1,0,29,desolation,0
Just came back from camping and returned with a new song which gets recorded tomorrow. Can't wait! #Desolation #TheConspiracyTheory #NewEP,26,"['came', 'camping', 'returned', 'gets', 'recorded', 'wait']",6,1,0,25,desolation,0
RT kurtkamka: Beautiful desolation. Just me a couple of coyotes some lizards and the morning sun. #Phoenix #Ariz├½Ôûê_ http://t.co/0z1PvJVdpf,26,['desolation'],1,5,4,21,desolation,0
Watching Desolation of Smaug and I always love catching the cameos. Caught Jackson at the beginning and Colbert just now.,22,"['Watching', 'love', 'catching']",3,1,0,21,desolation,0
#Kids going to #school amidst the #desolation of an #earthquake #aftermath #Love #Olympus├½Ôûê_ https://t.co/pqds20yrJs,23,['going'],1,10,9,13,desolation,0
going to redo my nails and watch behind the scenes of desolation of smaug ayyy,15,"['going', 'redo']",2,12,11,3,desolation,0
Fotoset: elanorofrohan: 10th December 2013 Green Carpet in Zurich for the Swiss Premiere of The Desolation... http://t.co/BQ3P7n7w06,22,['desolation'],1,1,0,21,desolation,0
"This desperation dislocation
Separation condemnation
Revelation in temptation
Isolation desolation
Let it go and so to find away",18,"['Let', 'go', 'find']",3,10,9,8,desolation,0
destroy the free fandom honestly,5,['destroy'],1,1,0,4,destroy,0
Just made anthonys bed considering i destroy it everytime i fall asleep. Smh ????,18,"['made', 'considering', 'everytime']",3,7,6,11,destroy,0
Dem FLATLINERS who destroy creativity-balance-longevity &amp; TRUTH stand with Lucifer in all his flames of destruction https://t.co/WcFpZNsN9u,21,"['destroy', 'stand']",2,4,3,17,destroy,0
Watch These Super Strong Magnets Destroy Everyday Objects: http://t.co/bTUs5jejuy http://t.co/zrTfxLuk6R,15,['Objects'],1,1,0,14,destroy,0
@Beyonce @NicoleKidman @Oprah these money grubbing kikes need to get a clueI have no money but I can still destroy with telekinesis. Watch.,28,"['grubbing', 'need', 'get', 'have', 'destroy']",5,23,22,5,destroy,0
@SarniamakChris @Hromadske @kasiadear33  how silly that one of only two countries that can destroy the world has a say about world security,25,"['kasiadear33', 'destroy', 'has']",3,17,16,8,destroy,0
5/6 will destroy Reg C competitiveness.   The entire region will B over-saturated.   Yes Brockton gets $12M and RegC Commonwealth PPC and,24,"['destroy', 'B', 'gets']",3,3,2,21,destroy,0
(SJ GIST): 148 Houses Farm Produce Destroy... http://t.co/dkrGS2AWEX #StreetjamzDotNet | https://t.co/mR9KcGpIwM,20,['destroy'],1,1,0,19,destroy,0
Politics = Preschool Attitude: Russia orders to destroy all food coming from countries it doesn't like. - There is no hunger in the world?,28,"['=', 'destroy', 'coming', 'does', 'like', 'is']",6,9,8,19,destroy,0
Media stocks are getting destroyed (DIS FOXA CMCSA SNI AMCX VIAB VIA TWX) http://t.co/dQd3YtaZfG,18,"['are', 'getting', 'destroyed']",3,5,4,13,destroyed,0
@Musketeiro I see ISIL destroyed in Iraq in  May 2016. This may help Iraqis help Syrian government against it. But Nusrah and Ahrar not yet.,29,"['see', 'destroyed', 'help', 'help']",4,6,5,23,destroyed,0
#TheSun Flood: Two people dead 60 houses destroyed in Kaduna: Two people have been reportedly killed and 60 h...  http://t.co/Aawmx5w9sh,26,"['destroyed', 'have', 'been', 'killed']",4,10,9,16,destroyed,1
Black Eye 9: A space battle occurred at Star O784 involving 2 fleets totaling 3946 ships with 14 destroyed,20,"['occurred', 'involving', 'totaling']",3,20,19,0,destroyed,1
(SJ GIST): 148 Houses Farm Produce Destroyed By Flood In Sokoto: About 148 houses were on Saturday destroyed ... http://t.co/vqU1Y31hKU,26,"['were', 'destroyed']",2,22,21,4,destroyed,1
Soo..he'll be do a bit of repentance for the children's lives they've destroyed and continue to abuse and for... http://t.co/En3hKXQdD9,26,"['be', 'do', ""'ve"", 'destroyed', 'continue', 'abuse']",6,16,15,10,destroyed,0
#EverydayNaija | Flood: Two people dead 60 houses destroyed in Kaduna http://t.co/nOnm8C6L8P,16,['destroyed'],1,11,10,5,destroyed,1
Flood: Two people dead 60 houses destroyed in Kaduna: Two people have been reportedly killed and 60 houses ut... http://t.co/BDsgF1CfaX,25,"['destroyed', 'have', 'been', 'killed']",4,8,7,17,destroyed,1
@freeMurphy Your hot take on Canada's hitchhiking garbage-bot (destroyed in Philly) was sorely needed.,19,"['freeMurphy', 'take', 'hitchhiking', 'destroyed', 'was', 'needed']",6,12,11,7,destroyed,0
19000 homes destroyed in Gaza -- ZERO rebuilt. Join me in busting the blockade! Sign &amp; RT #Gaza #OpenGaza https://t.co/WF9GMhjh2M,28,"['destroyed', 'Join', 'busting']",3,3,2,25,destroyed,0
@kaytlinmartinez dude those enormous blizzards we destroyed from DQ ??,12,"['dude', 'destroyed']",2,8,7,4,destroyed,0
70 years after #ABomb destroyd #Hiroshima├½Ôûê├ï#BBC looks at wht #survived http://t.co/dLgNUuuUYn #CNV Watch Peace Vigils: http://t.co/jvkYzNDtja,27,"['looks', 'survived']",2,1,0,26,destroyed,0
Flood: Two people dead 60 houses destroyed in Kaduna: Two people have been reportedly killed and 60 houses ut... http://t.co/JixScpMdUD,25,"['destroyed', 'have', 'been', 'killed']",4,8,7,17,destroyed,1
@DavidVitter Hi David in 2003 I saw the USA walk into a war that destroyed the lives of millions. You can prevent a repeat. #IranDeal,29,"['saw', 'destroyed', 'prevent']",3,16,15,13,destroyed,0
Ford Truck Starts Up And Drives Off After Being DESTROYED By Tornado! http://t.co/IxJjlp1LVo,16,['Being'],1,1,0,15,destroyed,0
New RAN report from the frontlines of human rights abuses and forest destruction for fashion.: http://t.co/tYDXauuEnQ,20,['destruction'],1,13,12,7,destruction,0
#Putin decree results in destruction of 10 tons of imported cheese near Russia-Ukraine border. RT @Independent http://t.co/K3pnNktlXh,22,['imported'],1,6,5,16,destruction,0
How American war planners singled out Hiroshima for destruction http://t.co/B5OKgpSpbH,12,['singled'],1,9,8,3,destruction,0
The day of death destruction chaos; 60000 to 80000 people were killed instantly. Please take sometime to remember and think about others,24,"['were', 'killed', 'take', 'remember', 'think']",5,5,4,19,destruction,0
He is one of the three survivors of the destruction of Otsuka Village.,14,['is'],1,10,9,4,destruction,0
New RAN report from the frontlines of human rights abuses and forest destruction for fashion.: http://t.co/5xyE2Rkuri,20,['destruction'],1,13,12,7,destruction,0
Related News: The Bureaucrats Who Singled Out Hiroshima for Destruction - Global - The Atlantic |  http://t.co/Tnex4HUsnp,20,"['Related', 'Singled']",2,1,0,19,destruction,0
RSS: Russia begins mass destruction of illegally imported food   http://t.co/r6JDj9kIGm,13,"['begins', 'imported']",2,6,5,7,destruction,0
So you have a new weapon that can cause un-imaginable destruction.,12,"['have', 'cause']",2,11,10,1,destruction,0
Bomb squad set to detonate backpack Antioch Tenn. theater gunman had on him officials say - @Tennessean http://t.co/eb74iieIWn,21,"['squad', 'set', 'detonate', 'had', 'say']",5,5,4,16,detonate,1
Apollo Brown ft. M.O.P- Detonate - http://t.co/OMfGv9ma1W,9,['ft.'],1,1,0,8,detonate,0
Detonate (feat. M.O.P.) by Apollo Brown http://t.co/fllaBzGCRc,13,['detonate'],1,1,0,12,detonate,0
#Boulder deputies are waiting for the bomb squad to detonate grenade like this one found in Stearns lake today http://t.co/7cADM3lNkO,23,"['are', 'waiting', 'detonate', 'lake']",4,11,10,12,detonate,1
@BldrCOSheriff says 2nd grenade found is 'younger' that WWII era grenade found earlier. They'll detonate it at 8:00 tonight. @CBSDenver,26,"['says', 'found', 'is', 'found', 'detonate']",5,19,18,7,detonate,0
52.214904 5.139055 Nuke please. Target Hilversum please detonate 800 meters below surface.,14,"['please', 'detonate']",2,9,8,5,detonate,0
@channelstv:That's why terrorism is not d war for d army but for Intel agents who can counter their moves before they detonate their bombs.,29,"[""'s"", 'is', 'counter', 'detonate']",4,26,25,3,detonate,0
Apollo Brown - Detonate (Ft. M.O.P.) https://t.co/NlJVP3Vfyz #FIYA!,16,['detonate'],1,1,0,15,detonate,0
@SourMashNumber7 @tomfromireland @rfcgeom66 @BBCTalkback They didn't succeed the other two times either. Bomb didn't detonate&amp;Shots missed.,28,"['did', 'succeed', 'did', 'detonate', 'amp', 'missed']",6,22,21,6,detonate,0
#hiphop #news #indie Apollo Brown ├½Ôûê├è ├½Ôûê┬ñDetonate├½Ôûê├ÿ Ft. M.O.P. - &lt;a href='http://t.co/WnowfVCbMs... http://t.co/JxWOjxqndC,25,['detonate'],1,1,0,24,detonate,0
Ignition Knock (Detonation) Sensor-Senso Standard KS94 http://t.co/IhphZCkm41 http://t.co/wuICdTTUhf,14,['detonation'],1,1,0,13,detonation,0
Dorman 917-033 Ignition Knock (Detonation) Sensor Connector http://t.co/WxCes39ZTe http://t.co/PyGKSSSCFR,15,['detonation'],1,1,0,14,detonation,0
Ignition Knock (Detonation) Sensor-Senso fits 01-06 BMW 325Ci 2.5L-L6 http://t.co/gBVDNczjoU http://t.co/c211HISe0R,17,['fits'],1,1,0,16,detonation,0
Detonation fashionable mountaineering electronic watch water-resistant couples leisure tab├½Ôûê_ http://t.co/GH48B54riS http://t.co/2PqTm06Lid,15,['mountaineering'],1,1,0,14,detonation,0
Don't miss Chris #Appy's detonation of the myths obscuring our crime in #Hiroshima 70 yrs ago this month. @salon http://t.co/DlP8kPkt2k,28,"['Do', 'miss', 'obscuring']",3,8,7,20,detonation,0
Detonation fashionable mountaineering electronic watch water-resistant couples leisure tab├½Ôûê_ http://t.co/RqOvPljpse http://t.co/UhKwVSoWSt,15,['mountaineering'],1,1,0,14,detonation,0
#JerusalemPost WATCH: Israel performs controlled detonation of land mines on Golan Heights http://t.co/01HuX8Y9Gi,17,['controlled'],1,8,7,9,detonation,0
via Jerusalem Post: WATCH: Israel performs controlled detonation of land mines on Golan Heights... http://t.co/rFB2ft4wX0,20,['controlled'],1,10,9,10,detonation,0
Ignition Knock (Detonation) Sensor-Senso Standard KS225 http://t.co/IwrCPmjOah http://t.co/zZMM9xEccW,14,['detonation'],1,1,0,13,detonation,0
"We are on our way to Hiroshima.
Today is the 70th anniversary of the detonation of the atomic bomb.",21,"['are', 'is']",2,16,15,5,detonation,0
70 years after : Hiroshima and Nagasaki - consequences of a nuclear detonation @ICRC http://t.co/BKh7Z6CWWl,18,['detonation'],1,13,12,5,detonation,0
Obama Declares Disaster for Typhoon-Devastated Saipan,6,['Declares'],1,1,0,5,devastated,1
Man Currensy really be talkin that talk... I'd be more devastated if he had a ghostwriter than anybody else....,23,"['be', 'be', 'had']",3,13,12,10,devastated,0
├½Ôûê┬ñRichmond Coaches were devastated to hear of the death of their second driver Mr Chance who was sitting├½Ôûê_: Jam... http://t.co/y5Yhbb0hkf,24,"['were', 'devastated', 'hear', 'was']",4,4,3,20,devastated,0
Zayn Malik &amp; Perrie Edwards End Engagement: She├½Ôûê┬¼s ├½Ôûê┬©Devastated├½Ôûê┬¼ http://t.co/GedOxSPpL9 http://t.co/ACZRUOrYtD,18,['devastated'],1,1,0,17,devastated,0
@UN No more #GujaratRiot &amp; #MumbaiRiot92-93 which devastated 1000&amp;1000 Indianperpetrated by #Modi &amp; #ChawalChorbjp @UN_Women  @UNNewsTeam,31,['devastated'],1,13,12,18,devastated,0
(#LosDelSonido) Obama Declares Disaster for Typhoon-Devastated Saipan: Obama signs disaster declaration for Northern Ma...  (#IvanBerroa),23,['Declares'],1,1,0,22,devastated,1
Obama declares disaster for typhoon-devastated Saipan: President Barack Obama has declared the Commonwealth of... http://t.co/4k8OLZv9bV,19,"['declares', 'has', 'declared']",3,1,0,18,devastated,1
@WesleyLowery ?????? how are you going to survive this devastation?,17,"['are', 'going', 'survive']",3,16,15,1,devastation,0
I'm in utter shock and devastation you don't go to work to be left feeling how I do now. Life really is too short ??,29,"[""'m"", 'do', 'go', 'work', 'be', 'left', 'do', 'is']",8,7,6,22,devastation,0
In this fragile global economy considering the devastation the alternatives would cause ... it's the best reason .. https://t.co/zwVyisyP2B,22,"['considering', 'cause', ""'s""]",3,8,7,14,devastation,0
"In Kalmikya Astrakhan Volgagrad and Dagestan there is already no food left for the locusts

  http://t.co/79Fw9zWxtP via @TIMEWorld",21,"['is', 'left']",2,1,0,20,devastation,0
#HungerArticles: Nepal: Rebuilding Lives and Livelihoods After Quake Devastation http://t.co/LROuWjMbIx,15,['Rebuilding'],1,1,0,14,devastation,0
70 Years After Atomic Bombs Japan Still Struggles With War Past: The anniversary of the devastation wrought b... http://t.co/1erd2FPryP,23,['Struggles'],1,17,16,6,devastation,0
Devastation Walkthrough Part 11: http://t.co/BOjDByB9YA przez @YouTube,11,['devastation'],1,1,0,10,devastation,0
#Thorium Radioactive Weapons. Scandals murders and environmental devastation: - VIDEO http://t.co/mly7sDN6eV,16,['devastation'],1,10,9,6,devastation,0
Water now tops the charts for highest global risk in terms of devastation├½Ôûê_ ahead of nuclear war or a global pandemic http://t.co/nbcvbSO9nm,24,['tops'],1,13,12,11,devastation,0
IRIN Asia | Red tape tangles Nepal reconstruction | Nepal | Disaster Risk Reduction | Natural Disasters http://t.co/q7LG6ncf7G,20,['tangles'],1,1,0,19,disaster,0
More Natural Disaster Research Urgent http://t.co/5Cm0LfZhxn via #JakartaPost,11,['disaster'],1,1,0,10,disaster,0
├ò┬╝'Only the sea knows how many are dead' @MSF_Sea after last disaster in #Mediterranean turned into a massgrave  http://t.co/m0utLDif77,24,"['knows', 'are', 'turned']",3,14,13,10,disaster,0
@Tim_A_Roberts w/o giving up too much of Nana France reminds me of America right before the war in Iraq. A restlessness leading to disaster,26,"['giving', 'reminds', 'leading', 'disaster']",4,26,25,0,disaster,0
Strengthening partnerships #AfterHaiyan http://t.co/Ga14egplw9 #Haiyan #YolandaPh #Philippines #livelihood #disasterrecovery #disaster,19,['Strengthening'],1,19,18,0,disaster,0
CW500: Dealing with disaster - http://t.co/jq9nJ6Gko3,9,['Dealing'],1,5,4,4,disaster,0
Blue Bell May Be Close to a Return From Its Listeria Disaster... Hot on #theneeds #Recipes http://t.co/F56v61AmPt,22,['disaster'],1,1,0,21,disaster,0
Jeff Locke. Train wreck. F'in disaster. Fortunately the Pirates acquired a top quality starter in J.A... Oh wait. #Blowltan,25,"['acquired', 'wait']",2,8,7,17,disaster,0
#Metepec #Mexico - ?NIGHT DISASTER?...E(Oficial) @ #NitClub #mÔòáÔòØsica #mÔòáÔòØsica http://t.co/WTfJF9jjzs,24,['@'],1,1,0,23,disaster,0
DISASTER AVERTED: Police kill gunman with 'hoax device' at cinema http://t.co/tdHn9zy0ER  via #Foxnews,18,['kill'],1,1,0,17,disaster,0
TV: Vitaly Churkin Briliantly Exposes the Hypocrisy of the Ukraine's FM Klimkin About the MH17 Disaster http://t.co/tt4kVmvuJq,21,['Exposes'],1,1,0,20,disaster,0
Illinois Tornado Slipped Under The Radar Emergency Officials Say http://t.co/zhGu8yE1bj,12,['disaster'],1,1,0,11,disaster,0
Top insurer blasts lack of Australian Govt action on disaster mitigation http://t.co/sDgOUtWNtb via @smh,17,['disaster'],1,10,9,7,disaster,0
Disaster [Chapter 27] https://t.co/EAsxT3y84R http://t.co/CjUFunsDKg,11,['disaster'],1,1,0,10,disaster,0
@Gurmeetramrahim #MSGDoing111WelfareWorks Green S welfare force ke appx 65000 members har time disaster victim ki help ke liye tyar hai....,24,"['ke', 'ke']",2,15,14,9,disaster,0
"Keeps askin me what this means
Not like i got the answers
Plus if i say the wrong thing
This might just turn into a disaster",26,"['askin', 'means', 'got', 'say', 'turn']",5,26,25,0,disaster,0
"This Palestinian family was lucky but hundreds are feared dead in the latest boat disaster in the Mediterranean
https://t.co/cT5v3LcNKD",21,"['was', 'are', 'feared']",3,15,14,6,disaster,1
DISASTER AVERTED: Police kill gunman with 'hoax device' at cinema http://t.co/94SXKI7KVX,15,['kill'],1,1,0,14,disaster,0
Heat wave adding to the misery of internally-displaced Gazans http://t.co/jW3hN9ewFT via @PressTV http://t.co/NYWrkRQ7Kn,18,"['wave', 'adding']",2,1,0,17,displaced,0
#Myanmar  Displaced #Rohingya at #Sittwe point of no return http://t.co/cgf61fPmR0  #Prison like conditions #genocide IHHen MSF Refugees,24,['displaced'],1,1,0,23,displaced,0
Crews were out all day boarding up windows at the park at the Galleria apts. where fire displaced 55 this AM. http://t.co/NMPN2mqZgE,26,"['were', 'boarding', 'displaced']",3,19,18,7,displaced,0
.POTUS #StrategicPatience is a strategy for #Genocide; refugees; IDP Internally displaced people; horror; etc. https://t.co/8owC41FMBR,24,"['is', 'displaced']",2,15,14,9,displaced,1
300000 Dead 1200000 injured 11000000 Displaced this is #Syria 2015 visit  http://t.co/prCI76hOwu  #US #Canada http://t.co/rTCuFaG0au,22,['is'],1,1,0,21,displaced,1
.POTUS #StrategicPatience is a strategy for #Genocide; refugees; IDP Internally displaced people; horror; etc. https://t.co/rqWuoy1fm4,24,"['is', 'displaced']",2,15,14,9,displaced,1
#Myanmar 's Displaced #Rohingya at #Sittwe point of no return http://t.co/gsa4o1mjNm Prison-like conditionsprivation http://t.co/i5ma6eWuwc,21,['displaced'],1,1,0,20,displaced,1
.POTUS #StrategicPatience is a strategy for #Genocide; refugees; IDP Internally displaced people; horror; etc. https://t.co/rqWuoy1fm4,24,"['is', 'displaced']",2,15,14,9,displaced,1
#KCA #VoteJKT48ID 12News: UPDATE: A family of 3 has been displaced after fired damaged housed near 90th and Osborn. Fire extinguished no i├½Ôûê_,28,"['has', 'been', 'displaced', 'fired', 'damaged', 'housed', 'extinguished']",7,15,14,13,displaced,0
@I_AmTalia @SGC72 'Thousands of people were displaced/injured/killed but hey now there's more opportunity for different restaurants!',21,"[""'Thousands"", 'were', 'displaced/injured/killed', ""'s""]",4,9,8,12,displaced,1
Philippines Must Protect Internally Displaced Persons Warns UN Expert http://t.co/xLZWTzgQTC,12,['displaced'],1,1,0,11,displaced,0
At least 180 dead a million displaced in India floods - India | ReliefWeb http://t.co/0abgFgLH7X,17,['displaced'],1,7,6,10,displaced,1
#KCA #VoteJKT48ID 12News: UPDATE: A family of 3 has been displaced after fired damaged housed near 90th and Osborn. Fire extinguished no i├½Ôûê_,28,"['has', 'been', 'displaced', 'fired', 'damaged', 'housed', 'extinguished']",7,15,14,13,displaced,0
9000 Photographs from 1800's British Mandate of Palestine - with no trace of 'Palestinians' http://t.co/X8i0mHYRmN,19,['displaced'],1,1,0,18,displaced,0
#mightyworld Thousands displaced after monsoon rains in Myanmar: Tens of thousands of people have been displac... http://t.co/HkSDk89c6C,22,"['displaced', 'have', 'been']",3,4,3,18,displaced,1
Angry Woman Openly Accuses NEMA Of Stealing Relief Materials Meant For IDPs: An angry Internally Displaced woman... http://t.co/C1vzJOr2qz,22,['Stealing'],1,1,0,21,displaced,0
.POTUS #StrategicPatience is a strategy for #Genocide; refugees; IDP Internally displaced people; horror; etc. https://t.co/rqWuoy1fm4,24,"['is', 'displaced']",2,15,14,9,displaced,0
local family displaced by fire http://t.co/f1nu18CArd via @gofundme  Lets help that family out please,17,"['displaced', 'help']",2,3,2,14,displaced,0
Historic flooding across Asia leaves hundreds dead millions displaced: http://t.co/4roisyXJlw http://t.co/3R8QoZJt7T,16,"['flooding', 'leaves', 'displaced']",3,9,8,7,displaced,0
Angry Woman Openly Accuses NEMA Of Stealing Relief Materials Meant For IDPs: An angry Internally Displaced wom... http://t.co/TEq7SrI57P,22,['Stealing'],1,1,0,21,displaced,1
#Myanmar  Displaced #Rohingya at #Sittwe point of no return http://t.co/qegMRhSms2  #Prison like conditions #genocide @IHHen @MSF @Refugees,27,['displaced'],1,1,0,26,displaced,1
Philippines Must Protect Internally Displaced Persons Warns UN Expert - The Diplomat http://t.co/V0yRfH9DKc,15,['displaced'],1,1,0,14,displaced,0
#Myanmar  Displaced #Rohingya at #Sittwe point of no return http://t.co/cgf61fPmR0  #Prison like conditions #genocide IHHen MSF Refugees,24,['displaced'],1,1,0,23,displaced,0
40 displaced by Ocean Township apartment fire #NewYork - http://t.co/uelZ59wVOm,13,['displaced'],1,2,1,11,displaced,1
PennLive - Two families displaced by Mechanicsburg blaze - No one was injured in the fire. http://t.co/OHYD7Hhcpe,20,"['displaced', 'was', 'injured']",3,5,4,15,displaced,1
@peterjukes A crime that killed/displaced millions. In which systematic torture was carried out. But look. GrahamWP fired a gun! Arrest him!,27,"['peterjukes', 'killed/displaced', 'was', 'carried', 'look', 'fired']",6,1,0,26,displaced,1
'@PhelimKine: #Myanmar 's Displaced #Rohingya at #Sittwe point of no return http://t.co/8gO68KjE4b  http://t.co/0KrW1zYaHM',24,['displaced'],1,1,0,23,displaced,0
Could Billboard's Hot 100 chart be displaced by these social-media-driven music charts?    http://t.co/WVlaH8jRXe,17,"['be', 'displaced']",2,8,7,9,displaced,0
Real people. True stories. Real pain &amp; suffering. #displaced #RefugeesMatter #Syria  https://t.co/OEZ7O9AB2C,22,['suffering'],1,15,14,7,displaced,0
"Elem Pomo helping the displaced from the Rocky Fire. Please consider!
Elem Evacuation Center http://t.co/dYDFvz7amj via @gofundme",22,"['helping', 'displaced', 'consider']",3,5,4,17,displaced,0
#Nevada's ├½Ôûê┬©exceptional├½Ôûê┬¼ #drought steady at ~11%; ~ 95% of #NV in drought: http://t.co/Nyo1xueBFA @DroughtGov http://t.co/w0a1MJOrHY,28,['drought'],1,19,18,9,drought,0
U.S. in record hurricane drought http://t.co/8JvQI9UspL,8,['drought'],1,5,4,3,drought,0
U.S. record hurricane drought. http://t.co/fE9hIVfMxq,8,['drought'],1,4,3,4,drought,0
Worried about how the CA drought might affect you? Extreme Weather: Does it Dampen Our Economy? http://t.co/fDzzuMyW8i,22,"['Worried', 'affect', 'Does', 'Dampen']",4,6,5,16,drought,0
LLF TALK WORLD NEWS U.S. in record hurricane drought - The United States hasn't been hit by a major hurricane in t... http://t.co/oqeq4ueGF8,27,"['has', 'been', 'hit']",3,9,8,18,drought,0
w--=-=-=-[ NEMA warns Nigerians to prepare for drought http://t.co/5uoOPhSqU3,14,['prepare'],1,11,10,3,drought,0
#MakeWaterWork Okanagan! Drought rating maxed out - Okanagan Valley http://t.co/tXrBdaUBNN http://t.co/Ue78c7EgOX #WesternCanadaDrought,19,['maxed'],1,1,0,18,drought,0
El Monte attempts to shed reputation of delinquency in drought - The Pasadena Star http://t.co/2wGOUCOHOu,17,['shed'],1,10,9,7,drought,0
@MarcVegan @NonDairyKerry true. Also takes 16000 gal water to produce 1 lb hamburger. Drought in Midwest will be chaos,23,"['takes', 'produce', 'be']",3,1,0,22,drought,0
Gov. Brown links CA wildfire to drought http://t.co/jEvrCWUdpm,11,['drought'],1,8,7,3,drought,0
"Heat wave is relentless:  91├ò├¡F Feels Like 100 Humidity 55% +
relentless drought too: now Dominicana. I know is worse in other places.",28,"['is', 'drought', 'know', 'is']",4,15,14,13,drought,1
Treasures revealed as California drought drains lakes http://t.co/kAH1KmTrj7,10,"['revealed', 'lakes']",2,5,4,5,drought,0
CANADA BC DROUGHT: Okanagan region issued Level 4 rating - Okanagan River (Columbia trib) fishing suspended to Sep 30 http://t.co/r4yZHxk7lw,25,"['issued', 'suspended']",2,1,0,24,drought,0
It├½Ôûê┬¼s time to do away with drought.Check out how the #cloud #IOT are helping conserve water http://t.co/nnv3zwVANt,21,"['do', 'are', 'helping']",3,7,6,14,drought,0
U.S. in record hurricane drought http://t.co/JXOMdLtJ73,8,['drought'],1,5,4,3,drought,0
New drought monitor showing drought spreads in ETX. 'Severe Drought' in Marion/Harrison Counties. @KLTV7 http://t.co/v8eG2kSLoH,21,"['showing', '@']",2,5,4,16,drought,0
BLOG: Rain much needed as drought conditions worsen: Right now Charlotte and much of the surrounding area have├½Ôûê_ http://t.co/OLzaVTJFKH,23,"['needed', 'worsen', 'surrounding']",3,7,6,16,drought,1
#weed news How marijuana is making California drought worse - Christian Science Monitor http://t.co/2SZ7oKjRXi,17,"['weed', 'is', 'making']",3,9,8,8,drought,0
Pretty neat website to get the latest drought conditions in your area https://t.co/uaoDOquDa1,15,['get'],1,8,7,7,drought,0
Thought it was a drought!,6,"['Thought', 'was']",2,5,4,1,drought,0
You can't use as much water in a drought as you can with a flood!,17,['use'],1,10,9,7,drought,0
The Drought Is Real ??????,10,['drought'],1,1,0,9,drought,0
@Michael5SOS California is in a drought. what are you gonna do about this issue? if you want to be president this attitude won't work with m,31,"['is', 'are', 'gon', 'do', 'want', 'be', 'work']",7,7,6,24,drought,0
Water conservation urged for North Thompson: B.C. government declares a Level 3 drought level for the North Th... http://t.co/dJ4qw8YfW5,24,"['urged', 'declares']",2,15,14,9,drought,0
For these Californians it's like living in Africa's Sahel desert - just finding water a daily chore. http://t.co/ySG9vsrT4g,23,"[""'s"", 'finding']",2,1,0,22,drought,0
U.S. in record hurricane drought: The United States hasn't been hit by a major hurricane in the past nine years and it seems like that├½Ôûê_,27,"['has', 'been', 'hit', 'seems']",4,5,4,22,drought,0
#KondoByJaymOnI U.S. in record hurricane drought http://t.co/fqLSkejWxH #Anticipate,12,['drought'],1,7,6,5,drought,1
U.S. in record hurricane drought http://t.co/Wd4UdSxacq via CNN,10,['drought'],1,5,4,5,drought,0
California meets drought-fueled fire season with extra crews.. Related Articles: http://t.co/rKDzB0TGC3,14,"['meets', 'Related']",2,3,2,11,drought,0
Thought it was a drought @_ASHJ? http://t.co/V4Br5gjMIY,11,"['Thought', 'was']",2,5,4,6,drought,0
@_gaabyx we got purple activist I thought it was a drought,12,"['got', 'thought', 'was']",3,12,11,0,drought,0
We happily support mydrought  a project bringing awareness to the LA drought. Track your water├½Ôûê_ https://t.co/2ZvhX41I9v,19,"['support', 'mydrought', 'bringing', 'Track']",4,12,11,7,drought,0
'California's Burning:' Gov. on Drought Wildfires http://t.co/mkqSVp8E0G,13,['drought'],1,1,0,12,drought,0
LLF TALK  WORLD NEWS U.S. in record hurricane drought - The United States hasn't been hit by a major hurricane in ... http://t.co/ML8IrhWg7O,26,"['has', 'been', 'hit']",3,9,8,17,drought,0
.@karijobe and her band killed it tonight.  It was almost loud enough to drown out the tambourine behind me..... @codycarnes @AG_USA,28,"['killed', 'was', 'drown', '@']",4,17,16,11,drown,0
I can't drown my demons they know how to swim,11,"['drown', 'know', 'swim']",3,4,3,7,drown,0
We are getting some reports of flooding near Jonesboro High School. Please use caution when driving in the area. Turn around don't drown!,27,"['are', 'getting', 'flooding', 'Turn', 'do', 'drown']",6,26,25,1,drown,1
absolute drown your Wagyu steak in heaping piles of moist Smuckers Grape Jam,13,"['drown', 'heaping']",2,2,1,11,drown,0
Drown me you make my heart beat like the rain.,11,['make'],1,1,0,10,drown,0
Wtf this mom just drowned her child?!,9,['drowned'],1,5,4,4,drowned,0
Hundreds feared drowned as migrant boat capsizes off Libya http://t.co/7S1GfNEBgt,12,"['feared', 'drowned', 'capsizes']",3,3,2,9,drowned,1
Sadly before she could save humanity Ursula drowned in the drool of a protoshoggoth but at least she sort of died doing what she loved.,26,"['save', 'drowned', 'doing', 'loved']",4,8,7,18,drowned,0
Hundreds feared drowned as migrant boat capsizes off Libya: Hundreds of migrants are feared to have drowned af... http://t.co/bF3OhacB1r,23,"['feared', 'drowned', 'capsizes', 'are', 'feared', 'have', 'drowned']",7,18,17,5,drowned,1
100s of migrants feared drowned after 700 squeeze onto boat in Mediterranean.  http://t.co/lsyPtk18se,16,"['feared', 'drowned']",2,5,4,11,drowned,1
#DW Hundreds feared drowned as migrant boat capsizes off Libya: Hundreds of migrants are├½Ôûê_ http://t.co/VOX99FWKcX,19,"['feared', 'drowned', 'capsizes']",3,5,4,14,drowned,1
via @dw_english Hundreds feared drowned as migrant boat capsizes off Libya http://t.co/Cubc0nq6Fd #UFO4UBlogEurope,17,"['feared', 'drowned', 'capsizes']",3,6,5,11,drowned,1
Hundreds feared drowned as migrant boat capsizes off Libya: Hundreds of migrants are feared to have drowned af... http://t.co/Cbhe0eXIRA,23,"['feared', 'drowned', 'capsizes', 'are', 'feared', 'have', 'drowned']",7,18,17,5,drowned,1
Visting Georgina at The Drowned Rat Cafe.....awful view!! http://t.co/pYLFb3tI9U,15,['Visting'],1,1,0,14,drowned,1
Toddler drowned in bath after mum left room to fetch his pyjamas http://t.co/k9aSKtwXfL,15,"['drowned', 'left', 'fetch']",3,2,1,13,drowned,0
So I pick myself off the ground and swam before I drowned. Hit the bottom so hard I bounced twice suffice this time around is different.,28,"['pick', 'drowned', 'Hit', 'bounced', 'is']",5,12,11,16,drowned,0
#dw_english Hundreds feared drowned as migrant boat capsizes off Libya: Hundreds of migrants are feared to hav... http://t.co/i9HW0qZoVy,23,"['feared', 'drowned', 'capsizes', 'are', 'feared', 'hav']",6,5,4,18,drowned,0
Jacksonville  family bands together as memorial is planned for  ... http://t.co/tilgurKv7Z,13,"['bands', 'is', 'planned']",3,1,0,12,drowned,0
Hundreds feared drowned after another Mediterranean asylum seeker boat sinking http://t.co/zsYkzj2bzG,13,"['feared', 'drowned', 'sinking']",3,3,2,10,drowned,0
@BenWunsch I ALMOST DROWNED AT SEA,7,['ALMOST'],1,1,0,6,drowned,0
I got drowned like 5 times in the damn game today ????????????,23,"['got', 'drowned']",2,3,2,20,drowned,0
80 tons of cocaine worth 125 million dollars drowned in #Alameda .....now that's a American drought #coke,21,"['drowned', '..now', ""'s""]",3,9,8,12,drowned,0
Hundreds feared drowned as migrant boat capsizes off Libya http://t.co/pPJi1tCNML,12,"['feared', 'drowned', 'capsizes']",3,3,2,9,drowned,1
Hundreds of migrants feared drowned off Libya: Migrants stand next to their tent at a camp set near Calais├½Ôûê_ http://t.co/PY4mtW5xpM,23,"['feared', 'drowned', 'stand', 'set']",4,5,4,18,drowned,1
Having such a hard time with everything im drowning literally,10,"['Having', 'drowning']",2,9,8,1,drowning,0
Grace: this is not your first ' storm' you know bicycles fences trees will fly as well as idiots drowning that go by swollen rivers...,28,"['is', 'know', 'fly', 'drowning']",4,22,21,6,drowning,0
LONDON IS DROWNING AND IIII LIVE BY THE RIVEEEEEER,9,['drowning'],1,1,0,8,drowning,0
Family mourns drowning of 'superhero' toddler with rare epilepsy: Bradley Diebold suffered hundreds of epilept... http://t.co/aSAn4yGd48,21,"['mourns', 'suffered']",2,3,2,18,drowning,0
If you told me you was drowning. I would not lend a hand!,15,"['told', 'was', 'drowning', 'lend']",4,7,6,8,drowning,0
'Drowning' - Acrylic 08.05.15 https://t.co/X17fUBQBGG,8,"[""'Drowning""]",1,1,0,7,drowning,1
@TinyJecht Those eyes.. desperate like a mouse drowning in a septic tank.,14,['desperate'],1,9,8,5,drowning,0
@_jeesss_ @Ethereal_7 Hello 911 yeah we have someone drowning here send a medic http://t.co/7GiglwdMhy,18,"['have', 'send']",2,11,10,7,drowning,0
@HeyImBeeYT its like theres fire in my skin and im drowning from within ????,18,['fire'],1,12,11,6,drowning,0
No reported cases of people drowning in sweat...FYI,10,"['reported', 'drowning']",2,6,5,4,drowning,0
http://t.co/9y0pAJ8sxd Family mourns drowning of 'superhero' toddler with rare epilepsy - Chicago Tribune http://t.co/oLdjsowKY5,19,['mourns'],1,6,5,13,drowning,0
@NigelTanner1 Believe it or not we've had too MUCH rain here. Our newly planted maple trees are actually drowning.,23,"[""'ve"", 'had', 'planted', 'are', 'drowning']",5,22,21,1,drowning,0
Boy saves autistic brother from drowning: A nine-year-old in Maine dove into a pool to save his autistic brother from drowning,22,"['saves', 'drowning', 'save', 'drowning']",4,22,21,0,drowning,0
I have the experience performing cpr on a actual drowning victim.,12,"['have', 'performing']",2,10,9,2,drowning,0
Boy saves autistic brother from drowning: A nine-year-old in Maine dove into a pool to save his autistic brother from drowning,22,"['saves', 'drowning', 'save', 'drowning']",4,22,21,0,drowning,0
Boy saves autistic brother from drowning: A nine-year-old in Maine dove into a pool to save his autistic brother from drowning,22,"['saves', 'drowning', 'save', 'drowning']",4,22,21,0,drowning,0
Migrants drowning - we will be erecting monuments 100 years from now and shed tears for the most powerful nations' greed of letting them die,26,"['drowning', 'be', 'erecting', 'shed', 'letting', 'die']",6,2,1,24,drowning,0
Drowning doesn't sound half bad rn,7,"['does', 'sound']",2,1,0,6,drowning,0
Boy saves autistic brother from drowning #NewsVideos http://t.co/8NZt51ew14,11,"['saves', 'drowning']",2,6,5,5,drowning,0
Some poor sods arriving in Amman during yesterday's dust storm were diverted to Ben Gurion airport: http://t.co/jkpjpcH9i6,21,"['arriving', 'were', 'diverted']",3,1,0,20,dust storm,0
Kids Disappear in Dust Storm in Atmospheric Aussie Thriller http://t.co/0MNPCER9nO RT @Newz_Sacramento,15,['Disappear'],1,1,0,14,dust storm,1
NASA MODIS image: Dust storm over Morocco and the Straits of Gibraltar http://t.co/QWQnni7VMZ #duststorm,18,['dust storm'],1,1,0,17,dust storm,0
OH SHIT DUST'S STORM ATTACK AND FIDGET'S BULLET THING MADE SOME CRAZY RICOCHET ATTACK,16,['dust storm'],1,1,0,15,dust storm,0
"Totoooooo! Totoooooooooo!
'@Historicalmages: Dust storm approaching Stratford Texas 18th April 1935. http://t.co/4awC16uUWB'",20,['approaching'],1,1,0,19,dust storm,0
Severe storm weakening as it moves SE towards Lubbock area.  Outflow boundary may create dust and 50 mph gusts http://t.co/pw3tZU0tay,23,"['moves', 'create', 'http']",3,1,0,22,dust storm,1
When the answer my friend isn't blowing in the wind-IT'S YELLING! -How to Survive a Dust Storm http://t.co/9NwAJLi9cr http://t.co/tKMOtaeaCo,26,"['is', 'blowing', 'Survive']",3,1,0,25,dust storm,0
Kids Disappear in Dust Storm in Atmospheric Aussie Thriller http://t.co/TPOaprJudp RT @Newz_Sacramento,15,['Disappear'],1,1,0,14,dust storm,1
How to Survive a Dust Storm http://t.co/0yL3yT4YLH,9,['Survive'],1,1,0,8,dust storm,0
The dust storm chase scene is pretty damn cool. #GhostProtocol,12,['is'],1,1,0,11,dust storm,0
Dust Storm 'en route' from Alice Springs to Uluru http://t.co/4ilt6FXU45,13,['dust storm'],1,1,0,12,dust storm,1
Photo: susfu: Dust storm rolling onto the base by cptesco August 03 2008 at 09:39PM http://t.co/ekkruDQzbv,20,['rolling'],1,1,0,19,dust storm,1
There's a big storm brewing dark clouds thunder and rain carrying thick dust. This could be interesting.,20,"[""'s"", 'carrying', 'be']",3,1,0,19,dust storm,1
I-90 Vantage: Backups eastbound with low visibility due to a dust storm about 4 miles east of the bridge.,21,['dust storm'],1,1,0,20,dust storm,0
Good way to end the day!!! Geyser plus dust storm! http://t.co/l5VakLR59M,17,['end'],1,1,0,16,dust storm,0
dust storm in riyadh ????,8,['dust storm'],1,1,0,7,dust storm,0
Let it be gone away like a dust in the wind .... Big Wind like a Tornado with Blizzard Thunder and Storm its that what I always want it,30,"['Let', 'be', 'gone', 'want']",4,1,0,29,dust storm,0
Storm headed towards Idaho Falls with blowing dust &amp; winds to 60 mph.  US HWY 20 &amp; I15 look out.  #idwx http://t.co/0cR74m1Uxm,31,"['headed', 'blowing', 'winds', 'look']",4,1,0,30,dust storm,1
Currently driving through a dust storm. http://t.co/srUj5ZljGL,10,['driving'],1,1,0,9,dust storm,0
I learned more about economics from one South Dakota dust storm than I did in all my years in college.  -Hubert Humphrey,23,"['learned', 'did']",2,1,0,22,dust storm,0
Photoset: hookier: New stills from The Dust Storm (x) http://t.co/h8YjcFG8hv,16,['dust storm'],1,1,0,15,dust storm,0
Raw Video: Dust Storm Rolls Through Texas http://t.co/QllkOfdyzX http://t.co/rGjJuMnNah,14,['dust storm'],1,1,0,13,dust storm,0
DUST IN THE WIND: @82ndABNDIV paratroopers move to a loading zone during a dust storm in support of Operation Fury: http://t.co/uGesKLCn8M,26,"['move', 'loading']",2,1,0,25,dust storm,0
Wall of noise is one thing - but a wall of dust? Moving at 60MPH? http://t.co/9NwAJLi9cr How to not get blown away! http://t.co/j4NI4N0yFZ,30,"['is', 'Moving', '//t.co/9NwAJLi9cr', 'get', 'blown']",5,1,0,29,dust storm,0
Pickathon dust storm is sadly over but we have @sunsetballard in Seattle tonight to look forward to w/ @tomonakayama http://t.co/RtgGzWCAix,24,"['is', 'have', '@', 'look', 'w/']",5,1,0,23,dust storm,1
Kids Disappear in Dust Storm in Atmospheric Aussie Thriller http://t.co/iR7VaxehEW RT @Newz_Sacramento,15,['Disappear'],1,1,0,14,dust storm,1
@deadlydemi even staying up all night to he barrier for tÔòá┬│p and then having to run through a dust storm and almost passing out?,26,"['staying', 'barrier', 'having', 'run', 'passing']",5,1,0,25,dust storm,0
Going to a fest? Bring swimming goggles for the dust storm in the circle pit,16,['Going'],1,1,0,15,dust storm,0
Severe storm weakening as it moves SE towards Lubbock area.  Outflow boundary may create dust and 50 mph gusts http://t.co/kA1HBjlqVw,23,"['moves', 'create', 'http']",3,1,0,22,dust storm,0
A dust storm in Pheonix. http://t.co/AMgfOnzUSD,9,['dust storm'],1,1,0,8,dust storm,1
NASA MODIS image: Dust storm over Morocco and the Straits of Gibraltar http://t.co/Q1jBreEsXv #duststorm,18,['dust storm'],1,1,0,17,dust storm,0
#Earthquake #Sismo M 1.4 - 4km E of Interlaken California: Time2015-08-06 00:52:25 UTC2015-08-05 17:52:25 -07... http://t.co/wA5C77F8vQ,22,['earthquake'],1,1,0,21,earthquake,1
Contruction upgrading ferries to earthquake standards in Vashon Mukilteo - Q13 FOX http://t.co/E981DgSkab #EarthquakeNews,17,['upgrading'],1,5,4,12,earthquake,0
#3Novices : Renison mine sees seismic event http://t.co/2i4EOGGO5j A small earthquake at Tasmania's Renison tin project has created a tem├½Ôûê_,24,"['sees', '//t.co/2i4EOGGO5j', 'has', 'created']",4,14,13,10,earthquake,0
2.0 #Earthquake in Sicily Italy #iPhone users download the Earthquake app for more information http://t.co/V3aZWOAmzK,19,['download'],1,1,0,18,earthquake,1
USGS EQ: M 1.2 - 23km S of Twentynine Palms California: Time2015-08-05 23:54:09 UTC2015-08-05 16:... http://t.co/T97JmbzOBO #EarthQuake,24,['earthquake'],1,1,0,23,earthquake,0
Some of the aftershocks can be just as big as the initial earthquake.~ http://t.co/HKbPqdncBa,16,['be'],1,13,12,3,earthquake,1
#Sismo ML 2.4  NEAR THE COAST OF WESTERN TURKEY: Magnitude├òÔò®├òÔò®ML 2.4Region├òÔò®├òÔò®NEAR THE COAST OF WESTERN TURKEY... http://t.co/0wdAzLcM90 #CS,24,['earthquake'],1,1,0,23,earthquake,1
USGS EQ: M 0.6 - 8km SSW of Anza California: Time2015-08-06 01:26:24 UTC2015-08-05 18:26:24 -07:0... http://t.co/3bwWNLsxhB #EarthQuake,23,['earthquake'],1,1,0,22,earthquake,1
1.9 earthquake occurred 15km E of Anchorage Alaska at 00:11 UTC! #earthquake #Anchorage http://t.co/QFyy5aZIFx,19,['occurred'],1,14,13,5,earthquake,1
USGS EQ: M 1.9 - 5km S of Volcano Hawaii: Time2015-08-06 01:04:01 UTC2015-08-05 15:04:01 -10:00 a... http://t.co/3rrGHT4ewp #EarthQuake,24,['earthquake'],1,1,0,23,earthquake,1
Raffi_RC: RT SustainOurEarth: Oklahoma Acts to Limit Earthquake Risk at Oil and Gas Wells | scoopit http://t.co/yru4nPHdrf Loving all thi├½Ôûê_,24,"['Acts', 'Limit', 'Loving']",3,1,0,23,earthquake,1
#USGS M 0.9 - Northern California: Time2015-08-06 01:50:25 UTC2015-08-06 01:50:25 UTC at epicenter... http://t.co/mBo6OAnIQI #EarthTwerk,21,['earthquake'],1,1,0,20,earthquake,1
#SCSeEstaPreparando Light mag. 4.4 earthquake  - - 73km SW of Khuzdar Pakistan on Wednes... http://t.co/i6lmcccLv5 via @volcanodiscover,23,['earthquake'],1,7,6,16,earthquake,1
#Earthquake of M 2.9 - 140km W of Ferndale California http://t.co/8t8oSCs4w7,14,['earthquake'],1,1,0,13,earthquake,1
#USGS M 1.2 - 23km S of Twentynine Palms California: Time2015-08-05 23:54:09 UTC2015-08-05 16:54:09 -07:0... http://t.co/kF0QYBKZOL #SM,23,['earthquake'],1,1,0,22,earthquake,1
Nepal earthquake 3 months on: Women fear abuse https://t.co/iCTtZ0Divr via @@loupascale,16,['fear'],1,2,1,14,earthquake,0
#Children traumatised after the Nepal earthquake are educated on coping mechanisms.   http://t.co/UbwDBydK1a,16,"['traumatised', 'are', 'educated', 'coping']",4,7,6,9,earthquake,0
@GreenLacey GodsLove &amp; #thankU my sister for RT of NEW VIDEO http://t.co/cybKsXHF7d The Coming Apocalyptic US Earthquake &amp; Tsunami,27,"['thankU', '//t.co/cybKsXHF7d']",2,1,0,26,earthquake,0
USGS reports a M1.94 #earthquake 5km S of Volcano Hawaii on 8/6/15 @ 1:04:01 UTC http://t.co/Njd28pg9Xv #quake,21,['reports'],1,6,5,15,earthquake,1
GNS sees unnecessary deaths resulting from earthquake strengthening legislation http://t.co/4rYZMzSgDW ($),15,"['sees', 'resulting', 'strengthening']",3,7,6,8,earthquake,0
'There was a small earthquake in LA but don't worry Emily Rossum is fine' #difficultpeople is great,20,"['was', 'do', 'worry', 'is', 'is']",5,5,4,15,earthquake,1
USGS EQ: M 1.9 - 15km E of Anchorage Alaska: Time2015-08-06 00:11:16 UTC2015-08-05 16:11:16 -08:0... http://t.co/OjQ0KFg5ub #EarthQuake,23,['earthquake'],1,1,0,22,earthquake,1
#Earthquake #Sismo M 1.9 - 15km E of Anchorage Alaska: Time2015-08-06 00:11:16 UTC2015-08-05 16:11:16 -08:00 ... http://t.co/Z0VeR1hVM9,22,['earthquake'],1,1,0,21,earthquake,1
Contruction upgrading ferries to earthquake standards in Vashon Mukilteo: The upgrades will bring the vulnera... http://t.co/Au5jWGT0ar,20,"['upgrading', 'bring']",2,5,4,15,earthquake,0
5.3 #Earthquake in South Of Fiji Islands. #iPhone users download the Earthquake app for more information http://t.co/V3aZWOAmzK,22,['download'],1,1,0,21,earthquake,0
M1.57 [01:11 UTC]?3km NNW of Lake Henshaw California. http://t.co/f9KQksoSw3,16,['['],1,1,0,15,earthquake,1
earthquake drill atm,3,['drill'],1,1,0,2,earthquake,0
#USGS M 1.9 - 15km E of Anchorage Alaska: Time2015-08-06 00:11:16 UTC2015-08-05 16:11:16 -08:00 at epicen... http://t.co/HkIiPyX5jL #SM,24,['earthquake'],1,1,0,23,earthquake,1
@DArchambau THX for your great encouragement and for RT of NEW VIDEO http://t.co/cybKsXHF7d The Coming Apocalyptic US Earthquake &amp; Tsunami,25,['//t.co/cybKsXHF7d'],1,1,0,24,earthquake,0
1.57 magnitude #earthquake. 27 km from #Ramona CA #UnitedStates http://t.co/ZtOlVGkDuk,16,['UnitedStates'],1,4,3,12,earthquake,1
1.9 magnitude #earthquake. 16 km from Anchorage AK #UnitedStates http://t.co/wVu08yJGOK,15,['UnitedStates'],1,4,3,11,earthquake,1
Earthquake drill ??,4,['drill'],1,1,0,3,earthquake,0
#earthquake (EMSC): MD 2.9 OFF COAST OF NORTHERN CALIFORNIA http://t.co/6AiMd1uway G http://t.co/9cgbJwmhII,20,['earthquake'],1,2,1,18,earthquake,1
'There was a small earthquake in LA but don't worry Emmy Rossum is fine',16,"['was', 'do', 'worry', 'is']",4,5,4,11,earthquake,1
#SISMO ML 2.0 SICILY ITALY http://t.co/vsWivoDCkL,9,['earthquake'],1,1,0,8,earthquake,0
Sure the #Megaquake story brought a sense of panic but the question is: will anything really change? http://t.co/9f3rDN9N3D,23,"['brought', 'is', 'change']",3,1,0,22,earthquake,0
Earthquake : M 3.4 - 96km N of Brenas Puerto Rico: Time2015-08-05 10:34:24 UTC2015-08-05 06:34:24 -04:00 at├½Ôûê_ http://t.co/sDZrrfZhMy,21,['earthquake'],1,1,0,20,earthquake,1
Scared to be living in Seattle when this predicted earthquake is going to destroy ????,18,"['Scared', 'be', 'living', 'predicted', 'is', 'going', 'destroy']",7,10,9,8,earthquake,0
drinking pepsi im afraid i might spill some and then my headphones electrocute me.,15,"['drinking', 'afraid', 'spill', 'electrocute']",4,13,12,2,electrocute,0
I broke my charger. Hella trying not to electrocute myself and die rn ????????,22,"['broke', 'trying', 'electrocute', 'die']",4,10,9,12,electrocute,0
#KCA #VoteJKT48ID JoelHeyman: My loose understanding is: @ 750k subs AH will electrocute then eat Michael. Don't want 2 influence anythin├½Ôûê_,27,"['is', 'electrocute', 'Do', 'want']",4,17,16,10,electrocute,0
"@FoxNews He still has his beard - has he been visited by any1 while in prison? If he keeps that hideous beard electrocute him! 
#UglyPeople",29,"['has', 'has', 'been', 'visited', 'keeps']",5,25,24,4,electrocute,0
#pakistan#news# PAKPATTAN City News: Man electrocuted From Our Correspondent PAKPATTAN: A man was electrocuted... http://t.co/frpbNhVPyI,24,"['electrocuted', 'was', 'electrocuted']",3,20,19,4,electrocuted,1
Youth electrocuted in Khulna  | http://t.co/3EnyNdXpPm https://t.co/GQpi7jMKan via @sharethis,14,['electrocuted'],1,2,1,12,electrocuted,0
South Side factory where worker electrocuted pays $17000 penalty #Columbus http://t.co/nSGWiCYXFT,15,['electrocuted'],1,6,5,9,electrocuted,0
South Side factory where worker electrocuted pays $17000 penalty #Columbus - http://t.co/N8EzfCTfcE,16,['electrocuted'],1,6,5,10,electrocuted,0
Michael talking about when he was electrocuted omg #ROWYSOLouisville http://t.co/HxVfmoUhDM,13,"['talking', 'was', 'electrocuted']",3,7,6,6,electrocuted,0
I'm loving this classic barn shot! We may or may not have got electrocuted got stung a few times and stepped in... http://t.co/X6aSGRjsWC,28,"[""'m"", 'loving', 'have', 'got', 'electrocuted', 'got', 'stepped']",7,16,15,12,electrocuted,0
South Side factory where worker electrocuted pays $17000 penalty http://t.co/PENJHc4ZCx #Columbus #Ohio #news,19,['electrocuted'],1,6,5,13,electrocuted,0
MT @Earths_Voice Treatment of #tigers in #China is appalling: electrocuted in front of businessmen &amp; eaten http://t.co/JlWhaOwFQA #SaveTi...,28,"['is', 'appalling', 'electrocuted']",3,14,13,14,electrocuted,1
I was blow drying my hair &amp; the cable caught on fire. I let go of it as soon as I realized. Just before I could get electrocuted ??,34,"['was', 'drying', 'let', 'go', 'realized', 'get', 'electrocuted']",7,32,31,2,electrocuted,1
Do babies actually get electrocuted from wall sockets? I'm wondering how I and those before me survived childhood.,21,"['Do', 'get', 'electrocuted', ""'m"", 'wondering', 'survived']",6,5,4,16,electrocuted,0
"Zotar(50 skeleton alchemist) was electrocuted to death by Atamathon the Giant Golem on Golem Graveyard 1.
http://t.co/GpwrC1KZ5i",22,"['was', 'electrocuted']",2,8,7,14,electrocuted,1
#pakistan#news# NANKANA SAHIB City News: Electrocuted From Our Correspondent NANKANA SAHIB: A youth was electr... http://t.co/WERK9qibVV,25,"['Electrocuted', 'was']",2,1,0,24,electrocuted,1
Watching a man electrocuted on the roof of #mumbailocals is definitely a lesson.. People please learn!! #lessonforlife #marinelines #mumbai,25,"['Watching', 'electrocuted', 'is']",3,4,3,21,electrocuted,1
"Worked in factory pressing designs onto T-shirts was electrocuted 
d/t faulty ground. Boss docked my pay while I was at ER #WorstSummerJob",24,"['Worked', 'was', 'electrocuted', 'was']",4,9,8,15,electrocuted,1
Student electrocuted to death in school campus http://t.co/ryah8Fni5Q,10,['electrocuted'],1,2,1,8,electrocuted,1
Survival Kit Whistle Fire Starter Wire Saw Cree Torch Emergency Blanket S knife  - Full re├½Ôûê_ http://t.co/cm7HqwWUlZ http://t.co/KdwAzHQTov,22,['emergency'],1,1,0,21,emergency,0
11000 SEEDS 30 VEGETABLE FRUIT VARIETY GARDEN KIT EMERGENCY SURVIVAL GEAR MRE  - Full rea├½Ôûê_ http://t.co/VE78djgHa5 http://t.co/ugubwRPQFP,21,['emergency'],1,1,0,20,emergency,0
Emergency Flow  http://t.co/lH9mrYpDrJ mp3 http://t.co/PqhuthSS3i rar http://t.co/0iW6dRf5X9,13,['emergency'],1,1,0,12,emergency,0
Alaska├½Ôûê┬¼s Prince of Wales #ArchipelagoWolves are nearing #Extinction. Demand emergency protection! #StandForWolves  http://t.co/hBWoivJqkD,20,"['are', 'nearing', 'StandForWolves']",3,13,12,7,emergency,0
Plane from New York to Kuwait diverts to UK after declaring state of emergency http://t.co/5AIeXCBKFq,17,['declaring'],1,14,13,3,emergency,1
UPDATE: Indiana State Police reopening I-65 near Lafayette following emergency bridge repairs that closed key highway for about 28 hours.,22,"['reopening', 'following', 'closed']",3,11,10,11,emergency,0
SF Asian Women's Shelter crisis line (415) 751-0880. Emergency shelter/support services 4 non-English speaking Asian women &amp; children.,25,['emergency'],1,1,0,24,emergency,0
"Myanmar floods: Childfund https://t.co/pQHQ4JnZTT
 and International Needs https://t.co/FX0W2Sq05F and CARE Aust @CAREemergencies appeals",19,['emergency'],1,1,0,18,emergency,1
Gonna call up tomorrow with the aul 'emergency dental appointment' excuse just like the whole tooth falling out incident of last year,24,"['call', 'falling']",2,1,0,23,emergency,0
in BOTH 'peacetime and times of national emergency.',10,['emergency'],1,8,7,2,emergency,0
Former heroin addict shares story as city leaders sound alarm: City officials said emergency teams responded t... http://t.co/GZxIPMOknB,22,"['sound', 'said', 'responded']",3,15,14,7,emergency,0
Came across this fire video not mine..enjoy..#fire #firemen #firetruck #emergency #rescue #911 #summertime #sirens├½Ôûê_ http://t.co/hcYAJsAcfJ,26,['emergency'],1,15,14,11,emergency,0
Emergency hop kit? ;) jk  https://t.co/MkbQ2YE4Wq,10,['emergency'],1,1,0,9,emergency,0
Denali wolf population declined from 143 in 2007 2 just 48 in 2015. Reinstate emergency buffer zone #ProtectDenaliWolves @Alaska @adndotcom,24,"['declined', 'buffer', '@']",3,16,15,8,emergency,0
@chowtaxis of Newport a big thanks for the emergency run to pick Jackie up from Bristol temple messages much appreciated,21,"['run', 'pick', 'appreciated']",3,10,9,11,emergency,0
Be safe and be prepare from emergency kits to evacuation. Alertness esp women and children who are also @gmanews  https://t.co/3GALBowItN,24,"['be', 'prepare', 'are']",3,7,6,17,emergency,0
#EMERGENCY in Odai Bucharest Romania 600 Dogs Dying!They are so Hungry that they EAT EACH OTHER! http://t.co/pjigXPVPl0,23,"['Dying', 'are', 'EAT']",3,1,0,22,emergency,1
@POTUS Thx for emergency dec. http://t.co/DyWWNbbYvJ 4 days and no plan to get H20 to those who have no transport. Can you deploy troops?,29,"['get', 'have', 'deploy']",3,1,0,28,emergency plan,1
See Aug 4 2015 PoconoRecord @EmergencyMgtMag - How Many Households Have an #Emergency Plan? | http://t.co/7zlsUmIess http://t.co/TdccH01N7q,24,"['See', 'Have']",2,1,0,23,emergency plan,0
Our builder is having a dental emergency. Which has ruined my plan to emotionally blackmail him this afternoon with my bump.,23,"['is', 'having', 'has', 'ruined', 'blackmail']",5,1,0,22,emergency plan,0
"This from The City of Calgary - 

City of Calgary has activated Municipal Emergency Plan

The Municipal Emergency... http://t.co/hA5BoppeJy",22,"['has', 'activated']",2,1,0,21,emergency plan,0
Calgary takes another beating from summer storms; City activates emergency plan http://t.co/4oi9hMo7om,15,"['takes', 'activates', 'http']",3,1,0,14,emergency plan,1
"119 Sri Lanka's 'Emergency' Line. 
Busy for the past 30 mins. 
Suppose I need to plan my emergencies better. #SL #RT",28,"['need', 'plan']",2,1,0,27,emergency plan,0
Calgary takes another beating from summer storms; City activates emergency plan: It was another day of watching the├½Ôûê_ http://t.co/240ZLieBrk,23,"['takes', 'activates', 'was', 'watching']",4,1,0,22,emergency plan,0
@go2MarkFranco I spoke w Caleen Sisk. If #ShastaDam gets funded through Cali Emergency Drought Act I plan on doing story wfocus on Winnemem,26,"['spoke', 'gets', 'funded', 'plan', 'doing']",5,1,0,25,emergency plan,0
.@CityofCalgary activates emergency plan amid severe thunderstorm warning http://t.co/pc7S8NxJ6Q #yyc #abstorm http://t.co/9xoHmMlMDY,20,['warning'],1,1,0,19,emergency plan,1
City of Calgary activates Municipal Emergency Plan - http://t.co/IYs9xWPVMK,11,['emergency plan'],1,1,0,10,emergency plan,1
The City has activated the Municipal Emergency Plan. Primarily stay indoors avoid flooded areas Call 311 for... http://t.co/Ch6E7vTATR,22,"['has', 'activated', 'stay', 'avoid', 'flooded', 'Call']",6,1,0,21,emergency plan,1
City of Calgary activates Municipal Emergency Plan - 660 NEWS http://t.co/KFBjVJiVQB http://t.co/BN7Xpzqdm0,16,['emergency plan'],1,1,0,15,emergency plan,1
Hello Calgary!! Important news!! Please be advised!!! http://t.co/ARKTJ9Qn4S,17,"['be', 'advised']",2,1,0,16,emergency plan,1
Do you have an emergency drinking water plan? Download guide in English Spanish French Arabic or Vietnamese. http://t.co/S0ktilisKq,22,"['Do', 'have']",2,1,0,21,emergency plan,0
b/c it costs less to have sick people using emergency rooms?...grrrr.... http://t.co/vFbbcHwrFD,19,"['costs', 'have', 'using']",3,1,0,18,emergency plan,0
"├½Ôûê┬ñ@based_georgie: yo forreal we need to have like an emergency action plan incase donald trump becomes president├½Ôûê├ÿ
Whipe that lil baby",24,"['need', 'have', 'incase', 'becomes', 'lil']",5,1,0,23,emergency plan,0
#Biztip We recommend all businesses to get an alternative source of electricity. #Solar Wind and Batteries. Have an emergency plan! Now!,27,"['recommend', 'get', 'Have']",3,1,0,26,emergency plan,0
Calgary takes another beating from summer storms; City activates emergency plan http://t.co/u59DmRnlTK,15,"['takes', 'activates', 'http']",3,1,0,14,emergency plan,1
When your body's like 'go to fuck to sleep Sami' and your mind's like 'make an emergency plan for every natural disaster GO',27,"['fuck', 'sleep']",2,1,0,26,emergency plan,0
Calgary takes another beating from summer storms; City activates emergency plan #yyc #abstorm http://t.co/iQIXjtUEwH,19,"['takes', 'activates']",2,1,0,18,emergency plan,1
Senators calling for emergency housing: Boxer Feinstein back plan to move #homeless vets to VA campus http://t.co/Gm80X3vutf,21,"['calling', 'move']",2,1,0,20,emergency plan,0
Calgary takes another beating from summer storms; City activates emergency plan: Calgary Airdrie Okotoks and... http://t.co/i7QX4hAz6R,21,"['takes', 'activates']",2,1,0,20,emergency plan,1
Severe thunderstorm warning remains for #Cochrane. @cityofcalgary has enacted municipal emergency plan after today's storm. #abstorm,22,"['remains', 'has', 'enacted']",3,1,0,21,emergency plan,1
Can't fix stupid. MT @CBCCalgary Don't drive through flooded underpasses warns city as it enacts Municipal Emergency Plan. #yyc #abstorm,27,"['fix', 'Do', 'drive', 'warns', 'enacts']",5,1,0,26,emergency plan,0
A big issue left undone is HOW to get home if adverse weather hits. @GoTriangle has no real emergency plan in place https://t.co/s7xdXuudcy,27,"['left', 'is', 'get', 'has']",4,1,0,26,emergency plan,0
Storm prompts activation of City of Calgary's Municipal Emergency Plan: As the City of Calgary remains under a├½Ôûê_ http://t.co/7jcR8REgUv,23,['emergency plan'],1,1,0,22,emergency plan,1
City of Calgary activates municipal emergency plan as more thunderstorms approach http://t.co/8iHucO4GLW,14,['approach'],1,1,0,13,emergency plan,1
The Municipal Emergency Plan is now in effect. Stay safe everyone! #abstorm #yyc http://t.co/14CIcptKNa,20,['is'],1,1,0,19,emergency plan,1
Storm concludes City of Calgary's Municipal Emergency Plan deactivated http://t.co/93iaEec26T,13,"['concludes', 'deactivated']",2,1,0,12,emergency plan,1
@chrisroth98 @chaselabsports in an emergency situation late in the year. Not as a plan in camp,19,['emergency plan'],1,1,0,18,emergency plan,1
@TfLBusAlerts @TfLBusAlerts The Drive in Ilford closed both ways while emergency services deal with a call out. Buses are now stuck.,25,"['TfLBusAlerts', 'closed', 'are', 'stuck']",4,1,0,24,emergency services,1
@Glenstannard @EssexWeather do you know where abouts as I heard emergency services near by,16,"['do', 'know', 'heard']",3,1,0,15,emergency services,1
Sustainability Task Force Presents Levy to Fund Emergency Services - WDTV http://t.co/2FiBE2HAXC,14,['emergency services'],1,1,0,13,emergency services,0
#Nursing alert: Emergency Department Psychiatric RN (.90 FTE Day) | Providence Health &amp; Services | #Olympia WA http://t.co/Yu6NUe7gFB,27,['|'],1,1,0,26,emergency services,0
I am not an American but I have family who have served in the military work in the emergency services and work in... http://t.co/Pl2VzLrKVK,27,"['am', 'have', 'have', 'served']",4,1,0,26,emergency services,0
We're #hiring! Click to apply: RN II/EMERGENCY SERVICES/FT/7P-7A - http://t.co/NV3Uxv9IMX #Nursing #Houston TX http://t.co/ej30IhrEA9,24,"[""'re"", 'hiring', 'apply']",3,1,0,23,emergency services,0
Ballina emergency services have again been activated following a shark sighting of what has been described as two... http://t.co/Eu5tKTptpW,22,"['have', 'been', 'activated', 'following', 'has', 'been', 'described']",7,1,0,21,emergency services,1
Call for Tasmania's emergency services to be trained in horse rescues http://t.co/zVQwLpScSC,15,"['be', 'trained', 'http']",3,1,0,14,emergency services,0
Human Resources Processes Streamlined Insofar as Emergency Services Organization...AbboG,11,['emergency services'],1,1,0,10,emergency services,0
Removing tsunami debris from the West Coast: Karen Robinson Enviromental and Emergency services manager of the├½Ôûê_ http://t.co/1MeEo3WJcO,20,['Removing'],1,1,0,19,emergency services,0
#Breaking #News - Call for Tasmania's emergency services to be trained in horse ... - http://t.co/urJwsVr311 http://t.co/7JfrETeIi4,24,"['be', 'trained']",2,1,0,23,emergency services,0
Emergency Shutdown Systems - Edmonton http://t.co/F8GvWkFqox,8,['emergency services'],1,1,0,7,emergency services,0
@mickbland27 It is disturbing! Emergency services &amp; first responders should work together not slander try &amp; get each other killed.,27,"['is', 'disturbing', 'work', 'slander', 'get', 'killed']",6,1,0,26,emergency services,0
Services are returning to normal #SouthLine after a medical emergency at Yennora and urgent track equipment repairs at Cabramatta earlier.,22,"['are', 'returning']",2,1,0,21,emergency services,0
@bodminmoor1 experienced the expertise of some of Cornwalls finest emergency and rescue services!,15,['experienced'],1,1,0,14,emergency services,0
Just saw a car on the I-77 Fully engulfed in flames hahah,12,"['saw', 'engulfed', 'hahah']",3,9,8,3,engulfed,1
Men escape car engulfed in flames in Parley's Canyon crews investigating cause - http://t.co/P6cyLz5lpt http://t.co/Jpu9gIps9f,20,"['crews', 'investigating', 'cause']",3,4,3,16,engulfed,0
Tube strike live: Latest travel updates as London is engulfed in chaos - http://t.co/wrMSpcpml3 http://t.co/nWolqktxaf,20,"['updates', 'is', 'engulfed']",3,11,10,9,engulfed,1
Men escape car engulfed in flames in Parley's Canyon crews investigating cause - http://t.co/CYzlshlQhG http://t.co/nDiS8f1vzt,20,"['crews', 'investigating', 'cause']",3,4,3,16,engulfed,0
#TRAFFICALERT  Eastbound 210 Freeway at Citrus Ave in Azusa. Two motorcycles involved in accident with one fully engulfed in flames in lanes,24,"['involved', 'engulfed']",2,20,19,4,engulfed,1
Men escape car engulfed in flames in Parley's Canyon crews investigating cause - http://t.co/ldGWsYoWSs http://t.co/cnYVVY4WAT,20,"['crews', 'investigating', 'cause']",3,4,3,16,engulfed,1
He came to a land which was engulfed in tribal war and turned it into a land of peace i.e. Madinah. #ProphetMuhammad #islam,27,"['came', 'was', 'engulfed', 'turned']",4,8,7,19,engulfed,0
Tube strike live: Latest travel updates as London is engulfed in chaos: ├½Ôûê_  cross-London travel will be accepte...  http://t.co/vg8HRbebdA,24,"['updates', 'is', 'engulfed', 'be']",4,11,10,13,engulfed,1
Tube strike live: Latest travel updates as London is engulfed in├òÔò®chaos http://t.co/xkonKZ0Zl6 http://t.co/dXVtgi1BvO,18,"['updates', 'is', 'engulfed']",3,11,10,7,engulfed,1
He came to a land which was engulfed in tribal war and turned it into a land of peace i.e. Madinah. #ProphetMuhammad #islam,27,"['came', 'was', 'engulfed', 'turned']",4,8,7,19,engulfed,0
Men escape car engulfed in flames in Parley's Canyon crews investigating cause - http://t.co/tFan6qq2Ys http://t.co/rAkwWritPo,20,"['crews', 'investigating', 'cause']",3,4,3,16,engulfed,1
@godsfirstson1 and she wrapped his coat around herself. It practically engulfed her.,15,"['wrapped', 'engulfed']",2,13,12,2,engulfed,0
#RaheelSharif is manifesting how one RIGHT man at the helm can save a Sinking Ship engulfed in a Dark-Stormy-Tidal-Sea. Well Done.,24,"['is', 'manifesting', 'save', 'engulfed']",4,17,16,7,engulfed,0
Fully Engulfed Garage Fire: Propane Tanks Inside. Sunnymeade Dr.,12,['engulfed'],1,1,0,11,engulfed,1
Men escape car engulfed in flames in Parley's Canyon crews investigating cause - http://t.co/1TVFfba95l http://t.co/ALjwAWkxPj,20,"['crews', 'investigating', 'cause']",3,4,3,16,engulfed,1
#Tubestrike live: Latest travel updates as #London is engulfed in chaos - Telegraph http://t.co/AFzJamLFe6,19,"['updates', 'is', 'engulfed']",3,12,11,7,engulfed,1
Car engulfed in flames backs up traffic at Parley├½Ôûê┬¼s Summit http://t.co/RmucfjCaZr,13,['backs'],1,2,1,11,engulfed,1
Men escape car engulfed in flames in Parley's Canyon crews investigating cause - http://t.co/zevAn9kJzL http://t.co/UUZFs1L5Kt,20,"['crews', 'investigating', 'cause']",3,4,3,16,engulfed,1
Men escape car engulfed in flames in Parley's Canyon crews investigating cause - http://t.co/YfAVSuOgvl http://t.co/ISI1rLLCt0,20,"['crews', 'investigating', 'cause']",3,4,3,16,engulfed,1
Men escape car engulfed in flames in Parley's Canyon crews investigating cause - http://t.co/fxdH3U8Bq3 http://t.co/YZHVobGOcQ,20,"['crews', 'investigating', 'cause']",3,4,3,16,engulfed,1
'Tube strike live: Latest travel updates as London engulfed in chaos' &lt;- genuine baffling Telegraph headline,21,"['live', 'updates', 'engulfed']",3,10,9,11,engulfed,1
Lucas Duda is Ghost Rider. Not the Nic Cage version but an actual 'engulfed in flames' badass. #Mets,22,['is'],1,1,0,21,engulfed,0
RT @calestous: Tanzania elephant population declined by 60% in five years census reveals http://t.co/8zy9N6fX9T http://t.co/ITZ9masBvZ,22,"['declined', 'reveals']",2,1,0,21,epicentre,0
I feel like if MKayla and Cee ever got in the same room everyone should evacuate because it would be so petty and childish I couldn't deal,28,"['feel', 'got', 'evacuate', 'be', 'deal']",5,16,15,12,evacuate,0
CHICAGO (AP) ├½Ôûê├ï Organizers of Lollapalooza say they are reopening the music festival after the threat of a storm prompted them to evacuate,25,"['├½Ôûê├ï', 'say', 'are', 'reopening', 'prompted', 'evacuate']",6,25,24,0,evacuate,0
Learn how to evacuate your home in the event of a #wildfire view videos at http://t.co/bGeRLjamTE #CA #NV #UT #CO #OR http://t.co/sPuHuvgAsy,32,"['Learn', 'evacuate', 'videos']",3,4,3,28,evacuate,0
Disaster control teams are studying ways to evacuate the port area in response to tidal wave warnings.[900037],21,"['are', 'studying', 'evacuate', 'tidal']",4,8,7,13,evacuate,0
When there's a fire alarm going off in zehrs and we keep working for 20 minutes then decide to evacuate everyone..,22,"[""'s"", 'going', 'keep', 'working', 'decide', 'evacuate']",6,21,20,1,evacuate,0
California &amp;#039;monster&amp;#039; fire is 20% contained as 13000 are told to evacuate http://t.co/aPTAP6Yx1r,28,"['is', 'contained', 'are', 'told', 'evacuate']",5,25,24,3,evacuate,1
If you did a cannon ball into the ocean then Japan would evacuate.,14,"['did', 'evacuate']",2,13,12,1,evacuate,0
Firefigthers Evacuate from Northampton Township House Fire http://t.co/hPplD1jHtZ,10,['Evacuate'],1,1,0,9,evacuate,1
Fire crews evacuate passengers from a Gold Coast tram trapped when powerlines fell across a carriage. #TenNews 5pm http://t.co/hFyrloQY8q,23,"['evacuate', 'trapped', 'fell', 'TenNews']",4,3,2,20,evacuate,1
Disregard my snap story there is an angry white girl riot happening as we speak. #evacuate,18,"['is', 'happening', 'speak']",3,18,17,0,evacuate,0
SALHA(1):HARRY STYLES(2)U KNOW WHERE IS UR P_EOPLE#HURRY#EVACUATE THEM FROM#HELL.#JUST SHAHADA&amp;'PICK#ME'.#CLASS_SICK http://t.co/UpdDVr6jva,38,['evacuate'],1,1,0,37,evacuate,0
ISIS are deploying their troops to other battle grounds since deal with Turkey to evacuate buffer zone areas hence moving fronts to Assad.,24,"['are', 'deploying', 'evacuate', 'buffer', 'moving']",5,15,14,9,evacuate,1
Condemnation clearly replacing the latest response aimlessly dryer evacuate detersion de: HLg,13,['replacing'],1,9,8,4,evacuate,1
The EFAK would be designed for building occupants once they evacuate and report to their evacuation assembly sites,18,"['be', 'designed', 'evacuate', 'report']",4,11,10,7,evacuate,1
What if the fire up in the Catalinas gets worse and we have to evacuate the area. Aka no school tomorrow,22,"['gets', 'have', 'evacuate']",3,15,14,7,evacuate,1
@joonma_ dealbreaker that's it that's the dealbreaker s.o.s. abandon ship evacuate the building,17,"[""'s"", ""'s"", 'abandon', 'evacuate']",4,15,14,2,evacuate,0
So all the store's fire alarms went off today at work and we had to evacuate. I was like 'OMG!! I.S.I.S. ITS HAPPENING!!!!',33,"['went', 'had', 'evacuate', 'was']",4,17,16,16,evacuate,0
The U.S. also flew over each bomb site in World War II with warning letters telling people to evacuate,19,"['flew', 'warning', 'telling', 'evacuate']",4,19,18,0,evacuate,0
myGC: Broken powerlines evacuate Gold Coast tram suspend services http://t.co/6e7hHfeRz4,13,['evacuate'],1,5,4,8,evacuate,0
Sooo police dispatch said there was a person threatening to shoot up the Walmart on Rutherford &amp; they had to evacuate,23,"['said', 'was', 'threatening', 'shoot', 'had', 'evacuate']",6,23,22,0,evacuate,0
my father fucking died when the north tower collapsed ON HIM as he was trying to evacuate more people from the building.,23,"['died', 'collapsed', 'was', 'trying', 'evacuate']",5,17,16,6,evacuate,1
US govt refuses to evacuate 1000s of Americans from Yemen https://t.co/wQy3JOKuMH #yemen #usa #evacuation #abandoned,21,"['refuses', 'evacuate', 'abandoned']",3,5,4,16,evacuate,1
@ahhtheenikki And from what I can tell- they responded to today's gunman quickly and were able to evacuate all the ppl so no one was shot.,29,"['tell-', 'responded', 'were', 'evacuate', 'was', 'shot']",6,20,19,9,evacuate,1
California wildfires force thousands to evacuate: http://t.co/GFsl2Kwt5h via @YouTube,13,"['wildfires', 'force', 'evacuate']",3,6,5,7,evacuate,1
@pantalonesfuego Yeah I grew up in the canyon above L.A. We had to evacuate a few times.,19,"['grew', 'had', 'evacuate']",3,15,14,4,evacuate,1
Just had to evacuate the 100 Oaks Regal theater. I've never been more terrified.,17,"['had', 'evacuate', ""'ve"", 'been']",4,4,3,13,evacuate,1
@MeetKakarotto 'Don't bother while you were offline I managed to evacuate everyone out of here including Hinata so so go ahead and cause--,26,"['bother', 'were', 'managed', 'evacuate', 'including', 'cause']",6,13,12,13,evacuate,0
Tonight is being quite interesting... A few minutes ago the fire system went off and we had to evacuate the building.,23,"['is', 'being', 'interesting', 'went', 'had', 'evacuate']",6,20,19,3,evacuate,1
Town of Roosevelt Washington ordered to evacuate again as fire worsens http://t.co/Xkh5s1DR8d,14,"['ordered', 'evacuate', 'worsens']",3,7,6,7,evacuate,1
I just want everyone to know that Emilee was worried I was getting a milkshake when we were supposed to evacuate,21,"['want', 'know', 'was', 'worried', 'was', 'getting', 'were', 'supposed', 'evacuate']",9,21,20,0,evacuate,0
AND MY FAM HAD TO EVACUATE BC WE NEED POWER,10,['evacuate'],1,1,0,9,evacuate,1
@misschaela_ not yet.  Everywhere else except us and like a few other shops like Panda are evacuated but they haven't come for us yet.,28,"['are', 'evacuated', 'have', 'come']",4,19,18,9,evacuated,1
Does anyone know why #murfreesboro #walmart was evacuated this evening? @dnj_com,15,"['know', 'was', 'evacuated']",3,10,9,5,evacuated,0
UPDATE: Evaucation order for Roosevelt WA has been lifted: http://t.co/2NV0wHDLut,14,"['has', 'been', 'lifted']",3,1,0,13,evacuated,1
Chemical spill at GR water plant contained and water supply OK. @KocoMcAboy asked plant officials what happened: http://t.co/FHPLkEX3oK,22,"['contained', 'asked', 'happened']",3,1,0,21,evacuated,0
Green line service on south side disrupted after CTA train derails passengers evacuated. http://t.co/6eZkoof2Xt http://t.co/faCM78eg7K,20,"['disrupted', 'evacuated']",2,13,12,7,evacuated,1
Powerlines down over tram on GC Highway. Passengers have just been evacuated @9NewsBrisbane @9NewsGoldCoast http://t.co/KD3Qsakbi5,20,"['have', 'been', 'evacuated']",3,13,12,7,evacuated,1
A house was evacuated in Orakei after a bank collapsed and trees were felled by strong winds in Auckland ... http://t.co/UCuCmKypdN #NZ,25,"['was', 'evacuated', 'collapsed', 'were', 'felled']",5,4,3,21,evacuated,0
Red Cross re-opens shelter at Bickleton School after 25 homes evacuated in &amp; around Roosevelt WA due to wildfire. #LiveOnK2,24,"['evacuated', 'wildfire']",2,11,10,13,evacuated,1
New evacuation ordered for 25 homes in danger of Hwy. 8 fire near Roosevelt Wash. http://t.co/SQsyUeh4yI #KOIN6News http://t.co/199t7ND0pm,24,['ordered'],1,1,0,23,evacuated,1
They evacuated the mall. Again. ??,9,['evacuated'],1,2,1,7,evacuated,0
More than 300 campers evacuated as California wildfire blazes on officials say http://t.co/wwgAdpFFkW,15,"['evacuated', 'say']",2,5,4,10,evacuated,1
Chesterfield apartment complex evacuated because of fire #STL http://t.co/MIq39IOK3U,12,['evacuated'],1,4,3,8,evacuated,1
"Trafford Centre film fans angry after Odeon cinema evacuated following false fire alarm: 
 Twitter users tell ... http://t.co/dZLENSe1Gw",21,"['evacuated', 'following', 'tell']",3,9,8,12,evacuated,1
13000 evacuated as California firefighters fight flames to save homes. #RockyFire http://t.co/tB52o146tx http://t.co/tsbTiGDSDT,19,"['evacuated', 'fight', 'save']",3,2,1,17,evacuated,1
Trafford Centre film fans angry after Odeon cinema evacuated following false fire alarm http://t.co/pFMn63VnAm http://t.co/vKwqbOJFJc,19,"['evacuated', 'following']",2,9,8,10,evacuated,1
Gold Coast tram evacuated due to broken powerlines http://t.co/hJqbA42iY9 #Local NewsbrokenEmergency ServicesGold CoastpowerlineTramTr,16,"['evacuated', 'broken']",2,4,3,12,evacuated,1
Rocky fire in Northern California swells to 60000 acres; 12000 evacuated http://t.co/42gW2i2Q41 Portland #Phoenix #Miami #Atlanta #Casper,24,"['swells', 'evacuated']",2,12,11,12,evacuated,1
Trafford Centre film fans angry after Odeon cinema evacuated following false fire alarm: Twitter users tell of├½Ôûê_ http://t.co/PZeiXi4Xk7,21,"['evacuated', 'following', 'tell']",3,9,8,12,evacuated,0
5 dead 3 missing 103 families evacuated due to floods in Bukidnon: ... http://t.co/z0hSckvySN,17,"['missing', 'evacuated']",2,7,6,10,evacuated,1
"So many fires in NorCal they can't fight some of them. 

Pray for our firefighters air tanker pilots support crews &amp; evacuated people.",28,"['fight', 'support', 'evacuated']",3,26,25,2,evacuated,1
#FortitudeValley unit damaged and residents evacuated after fire broke out after 7am this morning #7News http://t.co/8iZgxCeLcc,20,"['damaged', 'evacuated', 'broke']",3,7,6,13,evacuated,1
Just got evacuated from the movie theatre for an emergency. Saw people running from another they're.,19,"['got', 'evacuated', 'running', ""'re""]",4,3,2,16,evacuated,1
#WorldNews Fallen powerlines on G:link tram: UPDATE: FIRE crews have evacuated up to 30 passengers who were tr...  http://t.co/EYSVvzA7Qm,27,"['have', 'evacuated', 'were']",3,16,15,11,evacuated,1
Passengers evacuated &amp; lanes blocked off as power lines come down over a Gold Coast tram @9NewsGoldCoast http://t.co/zZweEezJuG,23,"['evacuated', 'blocked', 'come', '@']",4,2,1,21,evacuated,1
ALERT! Sandy Hook Elementary School Evacuated After ├½Ôûê┬©Bomb Threat├½Ôûê┬¼ http://t.co/LwLexXjUS8,13,['evacuated'],1,1,0,12,evacuated,1
Evacuation orders lifted for Roosevelt in Highway 8 fire. http://t.co/e2HltYyFAk #koin6news http://t.co/pmxEzUo4AY,18,['lifted'],1,1,0,17,evacuated,1
Our thoughts are with these local residents! Time for some heavy rain!!! http://t.co/x3g2OX6K8R,19,['are'],1,1,0,18,evacuated,0
"Trafford Centre film fans angry after Odeon cinema evacuated following false fire alarm: 
 Twi... http://t.co/RYEQMxIrj8 #manchesterlite",21,"['evacuated', 'following']",2,9,8,12,evacuated,0
78 passengers evacuated safely after Green Line train derails. http://t.co/KzBSOhtwB4,13,['evacuated'],1,3,2,10,evacuated,1
Family evacuated after weather bomb http://t.co/2A4z8pmvVE,8,['evacuated'],1,2,1,6,evacuated,0
Hotel evacuated after fire on Shore Drive in Norfolk http://t.co/6X0xHlbxji,12,['evacuated'],1,2,1,10,evacuated,0
@115Film Doctor we must leave immediately the Core is unstable...The whole building is told to be evacuated. Take the research. We need...,28,"['leave', 'is', 'is', 'told', 'be', 'evacuated', 'Take', 'need']",8,20,19,8,evacuated,0
Evacuation order lifted for town of Roosevelt - Washington Times http://t.co/Kue48Nmjxh,13,['lifted'],1,1,0,12,evacuated,1
Grass fire burns past Roosevelt Wash. prompts evacuation http://t.co/BSuDXCPrSG #fire #firefighter,15,['prompts'],1,1,0,14,evacuated,1
Rocky Fire http://t.co/wxhMp5ppjq,5,['evacuated'],1,1,0,4,evacuated,1
Entire town of Roosevelt Wash. evacuated because of wildfire http://t.co/CmwEIojJ55,12,['evacuated'],1,6,5,6,evacuated,1
KATUNews: #SR14 remains closed as brush fire burns 1700 acres: http://t.co/QposKp3MWj #LiveOnK2 http://t.co/mTQjsvupwy,21,"['remains', 'closed']",2,1,0,20,evacuated,1
Green Line train derails on South Side passengers safely evacuated CTA says http://t.co/w6F7ZiS3KA http://t.co/t7L8jCjyq3,18,"['evacuated', 'says']",2,10,9,8,evacuated,1
Good thing there was actually just a legit fire in the mall and nobody evacuated!!,17,"['was', 'evacuated']",2,15,14,2,evacuated,0
Is it seclusion when a class is evacuated and a child is left alone in the class to force compliance?  #MoreVoices,23,"['Is', 'is', 'evacuated', 'is', 'left', 'force']",6,8,7,15,evacuated,0
Why does the secret bunker used by Cheney during 9/11 look like it was catered when ktchn staff had been evacuated?,22,"['does', 'used', 'was', 'catered', 'had', 'been', 'evacuated']",7,21,20,1,evacuated,0
Valley building evacuated after fire http://t.co/nyqF8GqMzg #queensland,10,['evacuated'],1,3,2,7,evacuated,1
13000 evacuated as California firefighters fight flames to save homes: CLEARLAKE OAKS Calif. ├½Ôûê├ï Wildfires lik... http://t.co/xwBYeaOWMw,21,"['evacuated', 'fight', 'save', 'lik']",4,2,1,19,evacuated,1
Rocky fire in Northern California swells to 60000 acres; 12000 evacuated http://t.co/mtfnbhRYZq Portland #Phoenix #Miami #Atlanta #Casper,24,"['swells', 'evacuated']",2,12,11,12,evacuated,1
Gold Coast tram hit by fallen powerlines: UP to 30 people have been evacuated from a tram on the Gold Coast af... http://t.co/xpPQnYHiWC,27,"['hit', 'fallen', 'have', 'been', 'evacuated']",5,15,14,12,evacuated,1
Tram travellers evacuated after powerlines come down in Surfers http://t.co/Qsheu3yF0W,12,"['evacuated', 'come']",2,3,2,9,evacuated,1
FAAN orders evacuation of abandoned aircraft at MMA: FAAN noted that the action had become necessary due to re... http://t.co/ZUqgvJnEQA,24,"['abandoned', 'noted', 'had', 'become', 're']",5,3,2,21,evacuation,1
#Breaking: Authorities have issued new mandatory evacuation notices for 25 homes to the North of the fire in #Roosevelt WA,23,"['have', 'issued']",2,9,8,14,evacuation,0
How an anatomic mother helps up-to-the-minute remodeling high evacuation hospital: IaAvRoIV,12,"['helps', 'remodeling']",2,9,8,3,evacuation,0
FAAN orders evacuation of abandoned aircraft at MMA http://t.co/5RXI47gCAj #NEWS @TodayNGR,15,['abandoned'],1,3,2,12,evacuation,0
Roosevelt Wash. under evacuation order due to wildfire http://t.co/FiJAPxyKRQ,11,['wildfire'],1,4,3,7,evacuation,0
Humboldt Cty Sheriff's Office has issued an evacuation advisory for 10 residence in the Lassics area... more info at http://t.co/ERUzBUQZYU,24,"['has', 'issued']",2,9,8,15,evacuation,0
FAAN orders evacuation of abandoned aircraft at MMA http://t.co/GsOMtDPmoJ,11,['abandoned'],1,3,2,8,evacuation,1
You'll neediness so taste up and down ulcerated waggon evacuation cornwall: bNVfDAg,14,"['neediness', 'taste']",2,11,10,3,evacuation,0
Do you know your hurricane evacuation route? Find it here: http://t.co/mWMVIcdW9O,15,"['Do', 'know']",2,6,5,9,evacuation,0
. @VELDFest announces refunds after Day two's extreme weather evacuation: http://t.co/PP05eTlK7t http://t.co/3Ol8MhhPMa,19,['@'],1,12,11,7,evacuation,0
Our mission to see the end of this movie last night @markoturner @annaciclismo after getting fire alarm evacuation http://t.co/5kFOVovjso,23,"['see', 'getting']",2,20,19,3,evacuation,0
The EFAK would be designed for building occupants once they evacuate and report to their evacuation assembly sites,18,"['be', 'designed', 'evacuate', 'report']",4,11,10,7,evacuate,0
Update: Bend FD says roofing co. workers accidentally cut through natural gas line in Post Office leading to evacuation for about a half-hr,24,"['says', 'roofing', 'cut', 'leading', 'evacuation']",5,20,19,4,evacuation,0
Evacuation Advisory for Swayback Ridge Area..voluntary-InciWeb:Mad River Complex Announcement http://t.co/vN73o4SGzJ #wildfires #calfires,18,['evacuation'],1,1,0,17,evacuation,0
Run out evacuation hospital indexing remedial of angioplasty dissertation at power elite hospitals dismayed:├½Ôûê_ http://t.co/VGvJGr8zoO,19,"['Run', 'indexing', 'dismayed']",3,3,2,16,evacuation,0
So the IFAK is an 'individual first aid kit' to treat a single trauma victim I think I should create the EFAK or evacuation first aid kit,28,"['is', 'treat', 'think', 'create', 'aid']",5,25,24,3,evacuation,0
"Elem Pomo helping the displaced from the Rocky Fire. Please consider!
Elem Evacuation Center http://t.co/dYDFvz7amj via @gofundme",22,"['helping', 'displaced', 'consider']",3,5,4,17,displaced,1
Bend Post Office roofers cut gas line prompt evacuation - http://t.co/6mF7eyZOAw,13,['cut'],1,9,8,4,evacuation,1
FAAN orders evacuation of abandoned aircraft at MMA: FAAN noted that the action had become neces... http://t.co/tlS40nqiPN Via @todayngr,24,"['abandoned', 'noted', 'had', 'become']",4,3,2,21,evacuation,1
FAAN gives owners of abandoned aircraft evacuation ultimatum http://t.co/zZpojgngAJ via @dailytimesngr. They should probe them too!,21,"['gives', 'abandoned', 'probe']",3,7,6,14,evacuation,1
Evacuation drill at work. The fire doors wouldn't open so i got to smash the emergency release glass #feelingmanly,22,"['open', 'got', 'smash']",3,1,0,21,evacuation,1
KCEM Jeff King reports a level 3 evacuation east of Roosevelt from Whitner rd to the county line between SR14 &amp; Hale rd.,26,['reports'],1,8,7,18,evacuation,1
#MadRiverComplex #CA #CASRF http://t.co/hjWLDCLiE4 Mad River Complex: Evacuation Advisory for Swayback Ridge Area,19,['evacuation'],1,1,0,18,evacuation,1
Updated #RockyFire map with Mandatory Evacuation areas (red) Advisory Evacuation (yellow) 2 Evac Centers (green) https://t.co/gZEgjoAKKw,25,['Updated'],1,1,0,24,evacuation,1
@CALFIRE_PIO Being prepared is crucial but returning to homes after evacuation only to find them robbed is criminal! #WillowFire,22,"['prepared', 'is', 'returning', 'find', 'robbed', 'is']",6,12,11,10,evacuation,1
UPDATE: The GNWT has just issued a voluntary evacuation order for cabin owners at Pickerel Lake near the Reid... http://t.co/RVSYxwj9Cp,24,"['has', 'issued']",2,10,9,14,evacuation,1
Evacuation order lifted for town of Roosevelt Wash. though residents warned to be ready to leave quickly http://t.co/Na0ptN0dTr,20,"['lifted', 'warned', 'be', 'leave']",4,1,0,19,evacuation,1
Walking down the middle of Michigan Ave last Sunday during #Lolla evacuation 2015 https://t.co/YrfZ5WJ7R2,17,['Walking'],1,13,12,4,evacuation,1
├½Ôûê┬ñA voluntary evacuation is being recommended at this time├½Ôûê├ÿ for Pickerel Lake cabins across highway from #Reidlake fire says MACA #NWT #YZF,25,"['is', 'being', 'recommended', 'cabins', 'says']",5,3,2,22,evacuation,1
IbrahimMisau : FAAN orders evacuation of abandoned aircraft at MMA http://t.co/5Zcje7arci (via Twitter http://t.co/haVXoBcSVU),20,['abandoned'],1,5,4,15,evacuation,1
Evacuation order lifted for town of Roosevelt: http://t.co/EDyfo6E2PU http://t.co/M5KxLPKFA1,14,['lifted'],1,1,0,13,evacuation,1
Survey: 52% of medical care facilities near nuclear plants lack evacuation plans http://t.co/vLMmCdPkRo,17,"['lack', 'http']",2,13,12,4,evacuation,0
Update: More from Bend FD on how a natural gas line cut prompted evacuation of the main Post Office this afternoon http://t.co/wMmkIrJ0Hw,25,['prompted'],1,15,14,10,evacuation,1
New evacuation ordered for 25 homes in danger of Hwy. 8 fire near Roosevelt Wash. http://t.co/SQsyUeh4yI #KOIN6News http://t.co/199t7ND0pm,24,['ordered'],1,1,0,23,evacuated,1
Reid Lake fire prompts campground evacuation order http://t.co/jBODKM6rBU,10,['campground'],1,6,5,4,evacuation,1
Evacuation order lifted for town of Roosevelt - Washington Times http://t.co/Kue48Nmjxh,13,['lifted'],1,1,0,12,evacuated,1
Evacuation order lifted for Roosevelt after #Wildfire misses town - KOMO News http://t.co/qCpMktGLLR,16,"['lifted', 'misses']",2,1,0,15,evacuation,1
Gas leak forces evacuation in east Saint John http://t.co/E1vkc2efsT #NB http://t.co/BeUa507Iug,16,['evacuation'],1,4,3,12,evacuation,1
@wyattmccab you'd throw a can of Copenhagen wintergreen on the ground that would explode on your enemies and give them mouth cancer,24,"['throw', 'explode', 'give']",3,16,15,8,explode,0
"Is he about to crash?
Did the Queen die?
Did something explode? 
Who knows. http://t.co/LThMwtl5fP",21,"['Is', 'crash', 'knows']",3,14,13,7,explode,0
Kendall Jenner and Nick Jonas Are Dating and the World Might Quite Literally Explode http://t.co/pfvzVPxQGr,17,['explode'],1,1,0,16,explode,0
im sooooooo full my stomach is going to explode,9,"['is', 'going', 'explode']",3,9,8,0,explode,0
@allen_enbot If you mess up it's gonna explode...,12,"['mess', ""'s"", 'explode']",3,11,10,1,explode,0
Chick masturbates a guy until she gets exploded on her face &gt; http://t.co/5QhoeHE9hf,17,"['masturbates', 'gets', 'exploded']",3,8,7,9,exploded,0
Kakeru Teduka: Bfore 70years of today in Hiroshima it's exploded the one atomic bomd. It is so sad day.http://t.co/8Vzl1ns2iO,24,"['Bfore', ""'s"", 'exploded', 'is']",4,12,11,12,exploded,0
@KopiteLuke1892 Its broken its fully exploded.,8,['exploded'],1,7,6,1,exploded,0
The Dress Memes Have Officially Exploded On The Internet http://t.co/3drSmxw3cr,12,['exploded'],1,1,0,11,exploded,0
Final #Medinah update: shot a 105. 49 on front (exploded with a) 56 on back. #ImKeepingMyDayJob (pic is famous #17) http://t.co/kcmbBwwp8G,33,"['exploded', 'is']",2,14,13,19,exploded,0
#Aphid population in #NorthIowa has exploded in last 4 days! http://t.co/cw6jxYVbNj #FromTheField,18,"['has', 'exploded']",2,8,7,10,exploded,0
Junko was 13 years old when the atomic bomb exploded over #Hiroshima on August 6 1945. http://t.co/lSpnyCVoLO http://t.co/Nh5pkFBfqm,23,"['was', 'exploded']",2,10,9,13,exploded,0
Holy hell the bathroom on car 649 smells like is exploded... @Metrolink,14,"['hell', 'is', 'exploded']",3,11,10,3,exploded,1
"that exploded &amp; brought about the
beginning of universe matches what's
mentioned in the versethe heaven and Earth
(thus the universe)",25,"['exploded', 'brought', ""what's"", 'mentioned']",4,2,1,23,exploded,1
Our electricity just fucking exploded they're trying to fix it now,12,"['fucking', 'exploded', ""'re"", 'trying', 'fix']",5,5,4,7,exploded,1
I didn't even know pens still exploded like that...ink everywhere,13,"['did', 'know', 'exploded']",3,8,7,5,exploded,0
#news #science London warship exploded in 1665 because sailors were recycling artillery cartridges: A dive to ... http://t.co/r4WGXrA59M,23,"['exploded', 'were', 'recycling']",3,7,6,16,exploded,0
At this moment 70 years ago (local time) the 'Little Boy' atomic bomb exploded over Hiroshima instantly killing at least 70-80000 people.,26,"['exploded', 'killing']",2,17,16,9,exploded,0
I can't take advantage of Smith Micro's deals right now because exploded car (hint hint shironu_akaineko AT... http://t.co/qbCTxPwhYP,24,"['take', 'exploded']",2,14,13,10,exploded,0
Kai Forbath just demolished a weather station set up on a drill field with a missed field goal. Thing just exploded into metal bits.,26,"['demolished', 'set', 'Thing', 'exploded']",4,22,21,4,exploded,1
oh yeah my ipod almost exploded last night i was using it while charging and shit was sparking akxbskdn almost died,21,"['exploded', 'was', 'using', 'charging', 'was', 'sparking', 'died']",7,6,5,15,exploded,1
#news #science London warship exploded in 1665 because sailors were recycling artillery cartridges... http://t.co/r4WGXrA59M #life #tech,23,"['exploded', 'were', 'recycling']",3,7,6,16,exploded,0
EE recalls Power Bar phone chargers after explosion burns woman ├½Ôûê├è The Register http://t.co/lhTvKcoISo,16,"['recalls', '├½Ôûê├è']",2,8,7,8,explosion,0
Hp lto-5 lump together warehouse information explosion is more than one divestment able: PMngiqy,15,"['is', 'PMngiqy']",2,7,6,8,explosion,0
Another Mechanical Mod Explosion: Man Injured When a 'Pharaoh' Mod Blows Up in His Hand - http://t.co/O82yVXbztv http://t.co/N5KmxuVeRg,24,['Injured'],1,1,0,23,explosion,0
GAElite 0    Explosion Greg 1 [Top 2nd] [0 Out] [0 balls] [0 strikes] ... No one on [P: #16 Morgan Orchard] [B: ],37,"['[', '[', '[', ']']",4,1,0,36,explosion,0
Report: Corey Brewer was drug tested after 51-point explosion http://t.co/HhlLQCkcEP,13,"['was', 'tested']",2,10,9,3,explosion,0
Young dancer moves about 300 youth in attendance at the GMMBC Youth Explosion this past Saturday. Inspiring! http://t.co/TMmOrvxsWz,22,"['moves', 'Inspiring']",2,1,0,21,explosion,0
Around 10 injured in explosion in chemical park in western Germany... http://t.co/XBznU0QkVS,15,['explosion'],1,5,4,10,explosion,1
I liked a @YouTube video http://t.co/bGAJ2oAX1p Huge Building Explosion at 2500fps - The Slow Mo Guys,19,['liked'],1,1,0,18,explosion,0
Large explosion rocks aluminum plant in southeast Missouri Re:Naomi-No Logo http://t.co/0WdsEIHYQu,15,['explosion'],1,2,1,13,explosion,1
GAElite 0    Explosion Greg 2 [Top 3rd] [0 Out] [0 balls] [0 strikes] ... No one on [P: #16 Morgan Orchard] [B: ],37,"['[', '[', '[', ']']",4,1,0,36,explosion,0
ITS A TIE DYE EXPLOSION ON IG HELP ME. IM DROWNING IN TIE DYE,15,['explosion'],1,1,0,14,explosion,1
Exploring New Worlds: Three Moments of an Explosion by China MiÔòá┬«ville http://t.co/OTrwZ1t9sp http://t.co/xVlkFCvfX5,20,['Exploring'],1,1,0,19,explosion,1
MORE--&gt;OSHA officers on siteinvestigating Noranda explosion -KFVS12 News Cape Girardeau Carbondale Poplar Bluff http://t.co/Pxyh7zo7vT,21,['siteinvestigating'],1,11,10,10,explosion,0
"A Time-Lapse Map of Every Nuclear Explosion Since 1945 - by Isao Hashimoto #War #atomicbomb 
https://t.co/V0t8H4Iecc",20,['explosion'],1,1,0,19,explosion,0
@colinhoffman29 I hope he does. And I hope you die in the explosion too,16,"['hope', 'does', 'hope', 'die']",4,15,14,1,explosion,0
A Pyrotechnic Artwork by Cai Guo-Qiang Explodes into a Blossom on the Steps of the Philadelphia... http://t.co/orOvZFsKU2,20,['explosion'],1,1,0,19,explosion,0
@lordRsBiscuits That's always good for a pretty explosion.,11,"['lordRsBiscuits', ""'s""]",2,10,9,1,explosion,0
EE recalls Power Bar battery packs after explosion in student's bedroom http://t.co/EKWTiHlwuf,15,['recalls'],1,8,7,7,explosion,0
Ahead of Print: A New Paradigm of Injuries From Terrorist Explosions as a Function of Explosion Setting Type.:... http://t.co/tqQc3yxBoR,24,['explosion'],1,1,0,23,explosion,0
kindermorgan gas explosion,3,['explosion'],1,3,2,0,explosion,1
We found a sunflower explosion on our walk. http://t.co/vLNmkLWWby http://t.co/P769eo49Fj,15,['found'],1,5,4,10,explosion,0
1 injured in Naples boat explosion http://t.co/89lcTH3Sx1,9,['injured'],1,6,5,3,explosion,1
"You Are Invited to The Expo Explosion Summer Event 2015! 
WHEN: August 14th Friday 2015
WHERE: Ben E Keith... http://t.co/yh4R7Ug21a",26,"['Are', 'Invited']",2,1,0,25,explosion,0
The gusto in persist had amongst empty-pated communication explosion: hPSsJD,11,"['had', 'amongst']",2,9,8,2,explosion,0
Hero of capitalism: Sprint employee promotes Sprint while Fox News interviews him as a shooting eyewitness: https://t.co/DtRPhCTmJx,21,"['interviews', 'shooting']",2,17,16,4,eyewitness,0
Read an eyewitness account from #Hiroshima on Aug. 6 1945 http://t.co/sbIP9g52YQ Mankind's worst invention.,19,['Read'],1,3,2,16,eyewitness,0
"Eyewitness accounts of survivors of Hiroshima gleaned from a
number of oral history projects https://t.co/yRQGNbLKaC",17,"['gleaned', 'https']",2,1,0,16,eyewitness,0
Dutch crane collapses demolishes houses: Dramatic eyewitness video captures the moment a Dutch crane hoisting... http://t.co/dYy7ml2NzJ,20,"['collapses', 'captures']",2,8,7,12,eyewitness,1
#Fracking #Ecocide Eyewitness to Extreme Weather: 11 Social Media Posts that Show Just How Crazy T... http://t.co/dEdDH8Rme8 #Revolution,25,"['Fracking', 'Extreme', 'Posts']",3,1,0,24,eyewitness,0
Read an eyewitness account from #Hiroshima from this day in 1945 http://t.co/njAffyjaRz http://t.co/1xHSuEwQn4 #LIFE,20,['Read'],1,3,2,17,eyewitness,0
Interesting approach but doesn't replace Eyewitness video. The Ferguson Case - Video - http://t.co/vEcsoSRleR http://t.co/fiUOgj6hEF,21,"['does', 'replace']",2,1,0,20,eyewitness,0
#ClimateChange Eyewitness to Extreme Weather: 11 Social Media Posts that Show Just How Crazy Things A... http://t.co/czpDn9oBiT #Anarchy,24,"['Extreme', 'Posts', 'Things']",3,1,0,23,eyewitness,0
How 'Little Boy' Affected the People In Hiroshima - Eyewitness Testimonials! - https://t.co/5x5hSV5sKO,17,['Affected'],1,1,0,16,eyewitness,0
Lone Survivor: The Eyewitness Account of Operation Redwing and the Lost Heroes of SEAL Team├½Ôûê_ http://t.co/NXtWXJCAVh http://t.co/oL8ESFRGLE,22,['eyewitness'],1,1,0,21,eyewitness,0
How ├½Ôûê┬ñLittle Boy├½Ôûê├ÿ Affected the People In Hiroshima ├½Ôûê├è Eyewitness Testimonials http://t.co/mUAnfWcRW9,14,['Affected'],1,1,0,13,eyewitness,0
Read a Schoolboy├½Ôûê┬¼s Eyewitness Account of Hiroshima http://t.co/pq0D7MH3qr,10,['Read'],1,1,0,9,eyewitness,0
Cape Town: Thousands living on Cape Town's streets - Eyewitness News: Eyewitness NewsThousands living on Cape ... http://t.co/nAo6EWCPK2,23,"['Thousands', 'living', 'living']",3,1,0,22,eyewitness,0
Read an eyewitness account from #Hiroshima from this day in 1945 http://t.co/QUEDV2xxxX #LIFE,17,['Read'],1,3,2,14,eyewitness,0
Wake Up Kern County Eyewitness News Mornings airing RIGHT NOW on KBAK CBS29. http://t.co/rorKtMpqNs #liveonKBAK http://t.co/eDznX6GOud,22,"['Wake', 'airing']",2,1,0,21,eyewitness,0
On anniversary of Hiroshima bombing illustrated timeline of bombings. Eyewitness account particularly horrifying http://t.co/GZIb0mAwmn,17,"['bombing', 'horrifying']",2,1,0,16,eyewitness,0
With all due respect @RepMikeRogersAL y would u completely disregard ALL eyewitness accounts on Benghazi? #WereNotGruberVoters. #PJNet,22,['u'],1,13,12,9,eyewitness,0
Dutch crane collapses demolishes houses: Dramatic eyewitness video captures the moment a Dutch crane hoisting...  http://t.co/8PpZNGYAqE,20,"['collapses', 'captures']",2,8,7,12,eyewitness,1
RT patrickjbutler: Excellent damiengayle eyewitness account of Kids Company closure: 'You drop the bomb and expect├½Ôûê_ http://t.co/pHH1VmLfoo,21,['drop'],1,6,5,15,eyewitness,0
Dutch crane collapses demolishes houses: Dramatic eyewitness video captures the moment a Dutch crane hoisting... http://t.co/AJHKfh4e7G,20,"['collapses', 'captures']",2,8,7,12,eyewitness,1
Russian 'food crematoria' provoke outrage amid crisis famine memories: MOSCOW (Reuters) - Russian government ... http://t.co/Mphog0QDDN,22,['famine'],1,9,8,13,famine,1
'Food crematoria' provoke outrage amid crisis famine memories... http://t.co/fABVlvN5MS,13,['famine'],1,8,7,5,famine,1
http://t.co/tcXRtfaPZa Russian 'food crematoria' provoke outrage amid crisis famine memories http://t.co/eT9xxfdJnM,16,['http'],1,12,11,4,famine,1
'Russian 'Food Crematoria' Provoke Outrage Amid Crisis Famine Memories' by REUTERS via NYT http://t.co/jbYjbQEoiK #Ukraine,20,['famine'],1,1,0,19,famine,1
Russian 'food crematoria' provoke outrage amid crisis famine memories http://t.co/O4xLjnaV8F,13,['http'],1,9,8,4,famine,1
A memorial to the millions who perished in the Holodomor has been erected in the U.S. capital. http://t.co/Dj1LWZNIEH http://t.co/I9MxXkzHbL,24,"['perished', 'has', 'been', 'erected']",4,1,0,23,famine,0
exporting food wont solve the problem. africans will end famine n poverty by SOLVING OUT OF CONTROL TRIBAL WARS. https://t.co/UttaNbigRx,24,"['exporting', 'solve', 'end', 'SOLVING']",4,11,10,13,famine,0
'Food crematoria' provoke outrage amid crisis famine memories... http://t.co/REsxAvgpyJ,13,['famine'],1,8,7,5,famine,1
New article: Russian 'food crematoria' provoke outrage amid crisis famine memories read more at here http://t.co/9HiEiFHSmC,20,['read'],1,12,11,8,famine,1
Ukraine famine memorial in progress since 2006 goes up in Washington: http://t.co/Td7VIEoODi,15,"['famine', 'goes']",2,2,1,13,famine,0
The famine is coming to an end #Bluebell http://t.co/p9ryMfjcUX,12,"['is', 'coming']",2,2,1,10,famine,0
#IntlDevelopment Ukraine Famine Monument Erected In Washington: ├½Ôûê_ who perished in the Ukraine famine of the 19...  http://t.co/nUPy6EPAWn,23,['perished'],1,16,15,7,famine,0
Russian 'food crematoria' provoke outrage amid crisis famine memories http://t.co/GyH00mRKjm,13,['http'],1,9,8,4,famine,1
"Russia destroys food while people go hungry.  We're not the only ones with an insane government.
http://t.co/ZonNqGsxYw",22,"['destroys', 'go', ""'re""]",3,1,0,21,famine,1
@FinancialTimes Ethiopian regimes continue receiving foreign aid when famine struck for 2 years eastern Ethiopia  https://t.co/2fGgzQn1v4,19,"['regimes', 'continue', 'receiving']",3,10,9,9,famine,0
So shameful and tragic.. http://t.co/5p1e40qkGV,7,['famine'],1,1,0,6,famine,0
Reuters: Russian 'food crematoria' provoke outrage amid crisis famine memories http://t.co/SI02QRgukA http://t.co/0C1y8g7E9p,18,['http'],1,11,10,7,famine,0
Russian ├½Ôûê┬©food crematoria├½Ôûê┬¼ provoke outrage amid crisis famine├òÔò®memories http://t.co/sGECNKFThU,11,"['provoke', 'http']",2,8,7,3,famine,0
#Ukraine #Kyiv #News Radio Free Europe/Radio Liberty: Ukraine famine monument erected in ... http://t.co/ME5u1YqH4i #Kiev #Ukrainian #Ua,26,"['famine', 'erected']",2,13,12,13,famine,0
"NONSENSE &gt;&gt; famine memories  -- strong exaggeration of Ukrainian MSM
#ukraine #russia #?????????? #sanctions https://t.co/dDOTd7W2o8",35,['famine'],1,8,7,27,famine,0
Bolshevik government monopolized food supply to seize power over hunhry population. Artificial famine was the result https://t.co/0xOUv7DHWz,20,"['monopolized', 'seize', 'was']",3,14,13,6,famine,0
Russian 'food crematoria' provoke outrage amid crisis famine memories http://t.co/h6Z7hXUqtu via @YahooNews,16,['http'],1,9,8,7,famine,1
I've experienced the smell of rotting potatoes for the first time. The Famine must have been awful if the whole country smelled like that.,27,"[""'ve"", 'experienced', 'rotting', 'have', 'been', 'smelled']",6,1,0,26,famine,0
http://t.co/x1x6d5Enef Russian 'food crematoria' provoke outrage amid crisis famine memories http://t.co/XhehJFFT7g,16,['http'],1,12,11,4,famine,1
@SavageNation Reminds me when the Peasants destroyed their food when Stalin's army came to 'redistribute the wealth'. It caused famine/death,24,"['destroyed', 'came', ""'redistribute"", 'caused']",4,24,23,0,famine,0
UPDATE 1-Russian 'food crematoria' provoke outrage amid crisis famine memories: * Russian society still recal... http://t.co/J2erZbMjQD,21,['famine'],1,10,9,11,famine,0
Miners strike; Botha Apartheid SA Tutu Nobel prize; IRA bomb Brighton  Famine in Ethiopia. '84 feels like yesterday http://t.co/UZKssvj9CW,24,['famine'],1,1,0,23,famine,1
The Adventures of Mineness #9   The Famine Is Over http://t.co/spYmIQNeCj,13,['Is'],1,1,0,12,famine,0
"'Food crematoria' in Russia provoke outrage amid crisis famine memories
http://t.co/FelR5a1hBP",14,"['provoke', 'http']",2,10,9,4,famine,0
#Russian food crematoria provokes outrage amid crisis famine memories http://t.co/FjeaFgbZfJ,13,"['outrage', 'http']",2,9,8,4,famine,1
Maratha raiders scorched their lands &amp; Punjab refused them food aid during the 1943 famine wonder if Bengalis harbor some 'hard feelings',25,"['scorched', 'refused', 'harbor']",3,17,16,8,famine,0
Images of Famine ├½Ôûê├è Hope In Christ - A blog on what happens when we forget God http://t.co/9BLiDdNGtF #HopeinChrist @lifelettercafe,24,"['happens', 'forget']",2,1,0,23,famine,0
Russian 'food crematoria' provoke outrage amid crisis famine memories http://t.co/kZYvMnqHy7 via @Reuters,16,['http'],1,9,8,7,famine,0
Russian 'food crematoria' provoke outrage amid crisis famine memories - Yahoo News http://t.co/6siiRlnV6z,16,['famine'],1,9,8,7,famine,0
Protesters mark year since fatal police shooting in Wal-Mart (from @AP) http://t.co/3KbeJGmj0d,17,"['mark', 'shooting']",2,5,4,12,fatal,0
Police investigate fatal shooting on 71 Highway http://t.co/0KJjdaOJHI,10,['shooting'],1,3,2,7,fatal,0
11-Year-Old Boy Charged With Manslaughter of Toddler: Report: An 11-year-old boy has been charged with manslaughter over the fatal sh...,23,"['has', 'been', 'charged']",3,21,20,2,fatal,0
Boy 11 charged with manslaughter in shooting death of Elijah Walker: The 11-year-old appeared Wednesday in a... http://t.co/gtcFfaCvam,22,"['charged', 'shooting']",2,1,0,21,fatal,1
APD investigating fatal shooting of 3 year old child in southeast Anchorage http://t.co/qYccvUubkr,15,['investigating'],1,3,2,12,fatal,0
Investigators shift focus to cause of fatal Waimate fire http://t.co/c9dVDsSoFn,12,"['shift', 'focus', 'cause']",3,7,6,5,fatal,0
11-Year-Old Boy Charged With Manslaughter of Toddler: Report: An 11-year-old boy has been charged with manslaughter over the fatal sh...,23,"['has', 'been', 'charged']",3,21,20,2,fatal,0
Police: man in his early 30s dies after shooting on Vermont St.: http://t.co/HteZ4z48Od http://t.co/Eq4rXC9bb3,20,['shooting'],1,1,0,19,fatal,0
11-Year-Old Boy Charged With Manslaughter of Toddler: Report: An 11-year-old boy has been charged with manslaughter over the fatal sh...,23,"['has', 'been', 'charged']",3,21,20,2,fatal,0
Winnipeg police seek witnesses in Arlington and William fatal crash http://t.co/N2bCf4M64V,13,['seek'],1,9,8,4,fatal,0
11-Year-Old Boy Charged With Manslaughter of Toddler: Report: An 11-year-old boy has been charged with manslaughter over the fatal sh...,23,"['has', 'been', 'charged']",3,21,20,2,fatal,0
Trim error led to fatal Greek F-16 crash: ?A NATO safety investigation board report has determined that the ma... http://t.co/YhSahLKQo4,25,"['led', 'has', 'determined']",3,5,4,20,fatal,0
11-Year-Old Boy Charged With Manslaughter of Toddler: Report: An 11-year-old boy has been charged with manslaughter over the fatal sh...,23,"['has', 'been', 'charged']",3,21,20,2,fatal,0
Man charged over fatal crash near Dubbo refused bail http://t.co/HDBMfOVUtZ via @dailyliberal,15,"['charged', 'refused']",2,4,3,11,fatal,0
California man facing manslaughter charge in Sunday's wrong-way fatal crash in ... - http://t.co/1vz3RmjHy4: Ca... http://t.co/xevUEEfQBZ,23,['facing'],1,10,9,13,fatal,0
"Stockton police are investigating a fatal drive-by shooting in north Stockton
 http://t.co/j3x0DOY7R3",14,"['are', 'investigating']",2,6,5,8,fatal,0
11-Year-Old Boy Charged With Manslaughter of Toddler: Report: An 11-year-old boy has been charged with manslaughter over the fatal sh...,23,"['has', 'been', 'charged']",3,21,20,2,fatal,0
CA Cops: Illegal Immigrant with 4 Prior Arrests Charged in Fatal Sex Attack http://t.co/BL59Fw4SYS,17,['Charged'],1,1,0,16,fatal,0
11-Year-Old Boy Charged With Manslaughter of Toddler: Report: An 11-year-old boy has been charged with manslaughter over the fatal sh...,23,"['has', 'been', 'charged']",3,21,20,2,fatal,0
Investigators shift focus to cause of fatal Waimate fire http://t.co/a6Ro9bmXcy,12,"['shift', 'focus', 'cause']",3,7,6,5,fatal,0
11-Year-Old Boy Charged With Manslaughter of Toddler: Report: An 11-year-old boy has been charged with manslaughter over the fatal sh...,23,"['has', 'been', 'charged']",3,21,20,2,fatal,0
11-Year-Old Boy Charged With Manslaughter of Toddler: Report: An 11-year-old boy has been charged with manslaughter over the fatal sh...,23,"['has', 'been', 'charged']",3,21,20,2,fatal,0
Boy 11 charged with manslaughter in shooting death of Elijah Walker http://t.co/HUrIIVFDKC,14,"['charged', 'shooting']",2,1,0,13,fatal,0
Investigators shift focus to cause of fatal Waimate fire http://t.co/ej0mewOupS,12,"['shift', 'focus', 'cause']",3,7,6,5,fatal,0
#news #crimes Police ID victim in fatal crash that closed I-65 near Franklin: One person is d... http://t.co/9h0ym9OFsv #justice #courts,28,"['closed', 'is']",2,9,8,19,fatal,0
11-Year-Old Boy Charged With Manslaughter of Toddler: Report: An 11-year-old boy has been charged with manslaughter over the fatal sh...,23,"['has', 'been', 'charged']",3,21,20,2,fatal,0
Investigators shift focus to cause of fatal Waimate fire http://t.co/aDSvDpNP3r,12,"['shift', 'focus', 'cause']",3,7,6,5,fatal,0
Boy 11 charged in fatal shooting of 3-year-old http://t.co/FJ7kcRliR7,11,['charged'],1,5,4,6,fatal,0
"Police continue to investigate fatal shooting on Vermont &amp; 14th Street
http://t.co/daACJ5Hfmq",16,"['continue', 'investigate', 'shooting']",3,5,4,11,fatal,0
11-Year-Old Boy Charged With Manslaughter of Toddler: Report: An 11-year-old boy has been charged with manslaughter over the fatal sh...,23,"['has', 'been', 'charged']",3,21,20,2,fatal,0
11-Year-Old Boy Charged With Manslaughter of Toddler: Report: An 11-year-old boy has been charged with manslaughter over the fatal sh...,23,"['has', 'been', 'charged']",3,21,20,2,fatal,0
11-Year-Old Boy Charged With Manslaughter of Toddler: Report: An 11-year-old boy has been charged with manslaughter over the fatal sh...,23,"['has', 'been', 'charged']",3,21,20,2,fatal,0
Investigators shift focus to cause of fatal Waimate fire http://t.co/GoeTJGIhOp,12,"['shift', 'focus', 'cause']",3,7,6,5,fatal,0
EXCLUSIVE: In 179 fatalities involving on-duty NYPD cops in 15 years only 3├òÔò®├½Ôûê_ http://t.co/Cn1joMMUGH,17,['involving'],1,5,4,12,fatalities,1
Las Vegas in top 5 cities for red-light running fatalities - News3LV http://t.co/rEt82MdQnG,15,['fatalities'],1,10,9,5,fatalities,0
#NYC #News Legionnaires death toll rises to 8 in New York City: All eight fatalities were of older adults with... http://t.co/IQJ1Z3jXx8,27,"['rises', 'were']",2,18,17,9,fatalities,0
Highway Patrol reports uptick in statewide pedestrian fatalities - Post and Courier  http://t.co/xccv3D9IcR,15,['reports'],1,8,7,7,fatalities,0
We are totally unprepared for an EMP attack. Both China Russia and probably Isis possess them. 90% fatalities. Why are we pushing them?,28,"['are', 'possess', 'are', 'pushing']",4,21,20,7,fatalities,0
"City implores motorists not to speed after more reports of animal fatalities near nature reserves
-&gt; http://t.co/hiKF8Mkjsn",22,"['motorists', 'speed']",2,12,11,10,fatalities,0
Understand that there are no fatalities as no one was trapped inside the wholesale market. 8 fire engines and 40 fire fighters on scene.,26,"['are', 'was', 'trapped']",3,6,5,20,fatalities,0
As of the 6-month mark there were a total of 662 fatalities - 114 more than the first half of last year || http://t.co/reOz7H3Em8,26,"['were', '||']",2,12,11,14,fatalities,0
"http://t.co/pcdub1gQoC

#Figureskate #ToshikazuKatayama [Earthquake Report]@OnlyQuakeNews Get all the headlines of our earthquake-report.├½Ôûê_",20,['fatalities'],1,1,0,19,fatalities,0
"#Seattle's deadliest red light runner intersections revealed
 http://t.co/gHk9Xup6E0",12,['revealed'],1,1,0,11,fatalities,0
@unsuckdcmetro minor train leaves rails. Major = 1/13/82 Smithsonian Interlocking derails &amp; crashes into barrier wall w/ fatalities.,23,['leaves'],1,22,21,1,fatalities,0
Injuries Illnesses and Fatalities Latest Numbers : http://t.co/1uo1aTrbbJ,10,['fatalities'],1,1,0,9,fatalities,1
#Saudi Arabia: #Abha: Fatalities reported following suicide bombing at mosque; avoid area http://t.co/1xW0Z8ZeqW,20,"['reported', 'following', 'bombing']",3,1,0,19,fatalities,1
"-??-
; kitana
? her fatalities slay me
├½Ôûê├ïkody? (Vine by @KOMBATFANS33) https://t.co/uMajwSNLUF",22,"['kitana', 'slay']",2,9,8,13,fatalities,0
OSP concerned about mounting fatalities http://t.co/YmP0gInwza http://t.co/FYIOQvIOif,11,"['concerned', 'mounting']",2,5,4,6,fatalities,0
Estimated damage and fatalities of an Hiroshima-sized atomic bomb dropped on your hometown - http://t.co/BSrERJbY0I  #Hiroshima70,19,"['Estimated', 'dropped']",2,4,3,15,fatalities,0
The RCMP are reporting fatalities and serious injuries as a result of the collision on the TCH near Whitbourne.,20,"['are', 'reporting']",2,5,4,15,fatalities,0
Govt allocating 1.3 bn for flood action: Issue takes centre stage after fatalities in Veneto http://t.co/w3esX6Ud8t,19,"['allocating', 'takes']",2,14,13,5,fatalities,0
I liked a @YouTube video http://t.co/43sXG9Z6xh TREMOR IS NO JOKE!! [TREMOR DLC] [FATALITIES/X-RAY],22,['liked'],1,1,0,21,fatalities,0
'Among other main factors behind pedestrian fatalities are people failing to yield to a car' http://t.co/dgUL7FfJt2,19,"['are', 'failing', 'yield']",3,7,6,12,fatalities,0
Las Vegas in top 5 cities for red-light running fatalities http://t.co/kC8O81BcHG,13,['running'],1,10,9,3,fatalities,0
RCMP confirm fatalities in two-vehicle crash: TCH remains closed at Whitbourne due to accident http://t.co/0RokDuTyUN,18,"['remains', 'closed']",2,3,2,15,fatalities,0
...American casualties including 400000├½Ôûê├è800000 fatalities and five to ten million Japanese fatalities.' https://t.co/TxzXCNUDr8,18,"['including', 'ten']",2,13,12,5,fatalities,0
No UK train accident fatalities for 8th year running despite 4% increase in passenger journeys http://t.co/SuiLzS2S95 @healthandsafety,21,"['train', 'running', 'http']",3,5,4,16,fatalities,0
PolicyLab is at @CECANF's last public hearing in NYC today and tomorrow to address child abuse and neglect fatalities http://t.co/n2cY3Z4TPB,24,"['is', 'address']",2,21,20,3,fatalities,0
.@KurtSchlichter Yep considering that *millions* of Japanese fatalities were projected for Downfall. @_FreeMarketeer @dibang,19,"['considering', 'were', 'projected']",3,10,9,9,fatalities,0
#Shipping #Logistics eNCA | Fatalities as migrant boat capsizes in Med with hundreds onboard: ├½Ôûê_  capsized as i...  http://t.co/dnO7QXcFfh,25,"['Shipping', 'onboard', 'capsized']",3,1,0,24,fatalities,0
Message boards will display updated traffic fatalities (up from 582) and new message beginning today: Traffic deaths 616 - Slow for Workers.,26,"['display', 'beginning']",2,7,6,19,fatalities,0
Driver fatalities down on Irish roads but pedestrians and cyclists at more risk http://t.co/E7OJhpdfG2,16,['fatalities'],1,2,1,14,fatalities,1
@Truly_Stings Yo Dm me,5,['fatality'],1,1,0,4,fatality,0
Dying of Lyme disease: Case fatality rate nearly 100% http://t.co/RgT9GhODpW,14,['Dying'],1,7,6,7,fatality,0
@hrips_k when u do a fatality and like the corpse is still jittering,14,"['hrips_k', 'do', 'is', 'jittering']",4,7,6,7,fatality,0
Wow fatality on 101 big rig hit motorcyclist blood everywhere ?? wow. I'm sick.,18,"['hit', ""'m""]",2,2,1,16,fatality,1
Kosciusko police investigating pedestrian fatality hit by a train Thursday http://t.co/JILfbR0UfP,13,"['investigating', 'hit']",2,5,4,8,fatality,0
Afghan Soldier Kills US General America's Highest-Ranking Fatality Since Vietnam http://t.co/SiHQPlUIDW,14,['fatality'],1,1,0,13,fatality,0
Fatality https://t.co/GF5qjGoyCi,4,['fatality'],1,1,0,3,fatality,0
. @paulrogers002 Many #cancers which had a very high fatality rate 30 years ago kill a lot less today. #Oncology has achieved a lot.,29,"['had', 'kill', 'has', 'achieved']",4,12,11,17,fatality,0
Truck crash on 40w at US70 in Lebanon is a fatality. Very sad. Expect long delays through the morning.,22,"['is', 'Expect']",2,11,10,11,fatality,0
@LindaSOCVAT @TfLBusAlerts Yes apparently. Report of cow fatality as well sadly.,15,['fatality'],1,11,10,4,fatality,0
Death of Loretta Fuddy responsible for authenticating Obama birth certificate the sole fatality of nine on plane http://t.co/MzRhfOJT2j,20,"['authenticating', 'certificate']",2,13,12,7,fatality,0
@Dat_Vi fear of the unknown eh.,8,['fear'],1,3,2,5,fear,0
"The Opposite of Love is Fear Here├½Ôûê┬¼s Why
http://t.co/r5bXZzhXkm",11,['is'],1,1,0,10,fear,0
@CowgirlLawyer We must refuse to become a nation with everyone living in fear of being shot unawares by intoxicated &amp;/or crazy people.,27,"['refuse', 'become', 'being']",3,14,13,13,fear,0
Horror films are made by incredibly creative artists. We interviewed 21 of them in depth for The Anatomy of Fear. http://t.co/J6mpdsx9Lk,25,"['are', 'made', 'interviewed']",3,1,0,24,fear,0
FEAR GOD MORE NAJIB LESS: Nazir taking another stab at brother as govt threats police crackdowns├½Ôûê_ http://t.co/bQT9bjdUJG #WayneRooney_INA,22,"['taking', 'police']",2,1,0,21,fear,0
Nothing to fear. It's all about taking risks.,11,"['fear', ""'s"", 'taking']",3,3,2,8,fear,0
The Walking Dead spin off Fear the Walking Dead is on the 23rd ??????,19,"['spin', 'is']",2,1,0,18,fear,0
@21Joseph fire,3,['fire'],1,3,2,0,fire,0
@Miss_HoMaStToPa cause were on fire we are on fire were on fire now.. Yeah were on fire we are on fire were on fire nowwwwww,26,"['were', 'are', 'were', 'were', 'are', 'were']",6,25,24,1,fire,1
Setting things on fire is always an option,8,"['Setting', 'is']",2,4,3,4,fire,0
But put 'Flood of Fire' at the top of the list.  https://t.co/p5JPjgiipW,16,['put'],1,1,0,15,fire,0
This fire is WAY too close wtf is going on ???? http://t.co/drf3mmRbyx,17,"['is', 'is', 'going']",3,2,1,15,fire,1
Nothing like a good fire https://t.co/ItFbBz9xYC,8,['fire'],1,5,4,3,fire,0
California been shaking...catching on fire....and overcharging ppl on rent for the past 150+ years it ain't going nowhere.,24,"['been', 'shaking', 'catching', '.and', 'overcharging', 'ai', 'going']",7,7,6,17,fire,0
There's a fire in the Catalinas. Looks kinda cool. This picture doesn't do it justice. https://t.co/N0tAwGeZJx,23,"[""'s"", 'does', 'do', 'justice']",4,4,3,19,fire,0
I wanna set some shit on fire.,9,"['wan', 'set']",2,8,7,1,fire,0
In the words of Charlie Daniels 'Fire on the mountain run boys run.'├½Ôûê_ https://t.co/fz1HAEj255,18,"['run', 'run']",2,1,0,17,fire,0
I just checked in! ├½Ôûê├è at On Fire on @ZomatoAUS #LoveFood http://t.co/9l5kqykrbG,17,['checked'],1,1,0,16,fire,0
Smelling a Bon fire while driving makes me wanna be sitting near one making s'mores ????,20,"['Smelling', 'driving', 'makes', 'wan', 'be', 'sitting', 'making']",7,4,3,16,fire,0
Tractor-trailers collide on NJ Turnpike ├ò_ 42 http://t.co/OTEXyh79J8 http://t.co/MLZG4l0xnL,13,['├ò_'],1,1,0,12,fire truck,1
Fire Call: BRANT AV / DRUMMOND RD for Fire - *Structure - Single. Units: CAR 6 On Call Truck http://t.co/euDwNFyUeM,25,['fire truck'],1,1,0,24,fire truck,1
News On 6 Crew Neighbors Put Out Hallett Truck Fire http://t.co/TwqVKZY6Dn http://t.co/eeyveTLAHW,16,['Put'],1,1,0,15,fire truck,1
What a night! Kampers go on vacation to end our Dream Job party where fire truck sprays the pool with a hose! http://t.co/if0BiyubC4,27,"['go', 'end', 'sprays']",3,1,0,26,fire truck,0
#reno Truck trailer catches fire in Reno http://t.co/k5FIJaNkJb,11,['fire'],1,1,0,10,fire truck,1
wild night in the village of pugwash every fire truck is out that the town has which is like a fire truck for every house -population:6,26,"['is', 'has', 'is']",3,1,0,25,fire truck,1
#Irvine #SigAlert update: 133 S now closed at Irvine Blvd. 133 N closed past the 5 b/c of trash truck fire. @KNX1070,28,"['closed', 'closed']",2,1,0,27,fire truck,0
Ltd Toy Stamp &amp; Vintage Tonka TFD No 5 Pressed Steel Pumper Fire Truck  - Full read by eBay http://t.co/hTvyEnXCBS http://t.co/xSvPzxYRe3,27,['Pressed'],1,1,0,26,fire truck,0
'An 18-wheeler came along and struck the fire truck spinning it around 180 degrees and causing it to roll over' http://t.co/kmPfhGlhoo,24,"['came', 'struck', 'spinning', 'causing', 'roll']",5,1,0,23,fire truck,0
SIGALERT UPDATE #3***N-133 CLOSED AT 5 FWY UFN***- TRASH TRUCK FIRE,12,['fire truck'],1,1,0,11,fire truck,1
@BrookTekle_ didn't look like a murder scene just 1 cops a fire truck and 2 fire assistance cars along with a helicopter,24,"['did', 'look']",2,1,0,23,fire truck,1
News On 6 Crew Neighbors Put Out Hallett Truck Fire http://t.co/TwqVKZY6Dn http://t.co/QoInQ6gc9M,16,['Put'],1,1,0,15,fire truck,1
Former Township fire truck being used in Philippines - Langley Times http://t.co/L90dCPV9Zu #Philippines,16,"['being', 'used']",2,1,0,15,fire truck,1
Photo: #NJTurnpike ├ò_ NJ Turnpike Reopens Hours After Truck Fire In Linden; Driver Dead | NJ Turnpike... http://t.co/8SRT9rGaX7,24,['fire truck'],1,1,0,23,fire truck,0
Former Township fire truck being used in Philippines: Township of Langley assistant fire chief Pat Walker spen... http://t.co/r6YJw4xcKY,22,"['being', 'used', 'spen']",3,1,0,21,fire truck,0
@KapoKekito on northgate by the taco truck that's fire.,12,"[""'s""]",1,1,0,11,fire truck,0
It's never a good sign when you pull up to work &amp; there's five ambulances &amp; a fire truck in the bay. Wompppp at least it's Friday,35,"[""'s"", 'pull', 'work', 'amp', ""'s"", ""'s""]",6,1,0,34,fire truck,1
Fire truck and ambulance in K3 Phase 3. Hope everyone's okay. #PrayForSaipan,16,['fire truck'],1,1,0,15,fire truck,1
#SigAlert: North &amp; Southbound 133 closed btwn 5 fwy and Irvine Blvd due to truck fire. CHP is detouring traffic.,26,"['closed', 'is', 'detouring']",3,1,0,25,fire truck,1
@eeenice221 true because of the truck that caught fire?,11,['caught'],1,1,0,10,fire truck,1
133 N past  the 5 L lane is reopened. All other lanes are closed. All lanes are open on the 133 S. Trash truck fire cleanup. @KNX1070,31,"['is', 'reopened', 'are', 'closed', 'are']",5,1,0,30,fire truck,1
#SigAlert: North &amp; Southbound 133 closed btwn 5 fwy and Irvine Blvd due to truck fire. CHP is detouring traffic.,26,"['closed', 'is', 'detouring']",3,1,0,25,fire truck,1
Found this cool photo not mine 1952 Dodge Wayne bodied 4 window bus.  Ex Libby MT Fire Department truck. All ori├½Ôûê_ http://t.co/mcEjZzxgh8,26,['bodied'],1,1,0,25,fire truck,0
Fire shuts down part of NJ Turnpike ├ò_ 96 http://t.co/UzeatfZAyA http://t.co/ejrGK69aeq,15,['├ò_'],1,1,0,14,fire truck,1
This dude just pulled in front of our production with his truck on fire. Cops pulled up after we put it out http://t.co/e7DRPQUW4G,26,"['pulled', 'pulled', 'put']",3,1,0,25,fire truck,1
when a monster truck racer catches on fire at the fair,11,['fire truck'],1,1,0,10,fire truck,0
Truck fire clogs canyon road http://t.co/JRDwyy0aX4,8,['canyon'],1,1,0,7,fire truck,1
Truck catches fire in Warwick: A tree service truck caught fire around 7:15 p.m. on Wednesday in Warwick on In... http://t.co/nAdAvcq9VA,25,['caught'],1,1,0,24,fire truck,1
Pickup Truck Fire On Driscoll Bridge Snags Garden State Parkway #NewYork http://t.co/Q5YU2tZGte,15,['fire truck'],1,1,0,14,fire truck,1
rgj: Truck trailer catches fire in Reno http://t.co/kAF3WdRmTn,11,['fire'],1,1,0,10,fire truck,1
Truck driver died in Turnpike fire most lanes still closed police say http://t.co/tTmJgq6ayM via @njdotcom,18,"['died', 'closed', 'say']",3,1,0,17,fire truck,0
#Philippines Former Township fire truck being used in Philippines: ├½Ôûê_  of emergency equipment in Cebu Philippi...  http://t.co/aL28RVkqPQ,22,"['being', 'used']",2,1,0,21,fire truck,0
Jacksonville Fire &amp; Rescue Engine 58 - AWESOME TRUCK! - OFFICIAL JADE FL... https://t.co/ybdSlJw7c1 via @YouTube,23,['fire truck'],1,1,0,22,fire truck,0
#NJTurnpike ├ò_ #NJTurnpike Reopens Hours After Truck Fire In? http://t.co/oABJZtbVyZ http://t.co/GPBXRrDc07,18,['fire truck'],1,1,0,17,fire truck,0
I'm grateful for our first responders - @MNPDNashville @NashvilleFD and others - who acted so swiftly to save countless lives today.,25,"[""'m"", 'acted', 'save']",3,1,0,24,first responders,1
Central Indiana first responders are providing feedback at the third and final #FirstNet focus group today.... http://t.co/pehH7wHZ0g,22,"['are', 'providing']",2,1,0,21,first responders,0
├½Ôûê┬©We Can Help├½Ôûê┬¼ Says Denver Firefighter Working To Curb First Responder Suicide http://t.co/WtaFaepuKZ,15,['first responders'],1,1,0,14,first responders,0
First responders tell me he is lucky.... had someone riding with him today. http://t.co/jc16CZn0NC,19,"['tell', 'is', 'had', 'riding']",4,1,0,18,first responders,0
Carmike Cinemas on Antioch Shooting: 'We Are Grateful' for Staff and First Responders Safety Is 'Highest Priority' http://t.co/BehfHspPud,23,"['Are', 'Is']",2,1,0,22,first responders,0
I just added 'Sandy First Responders Lost Their Homes' to VIP Home Page Group on @Vimeo: https://t.co/lKXi6UXjaQ,22,['added'],1,1,0,21,first responders,0
Thankful for our first responders especially @MNPDNashville for life saving response today in Antioch!,16,"['@', 'saving']",2,1,0,15,first responders,0
Volunteers served first responders today during a tanker fire in Eufaula. Provided cold drinks and food. #okwx #tankerfire,22,"['served', 'Provided']",2,1,0,21,first responders,0
'The longer you wait the more people die': #Lafayette theater shooting first responders relied on training: http://t.co/yXOojnbr7m,23,"['wait', 'die', 'shooting', 'relied']",4,1,0,22,first responders,0
@pnppro1 Warm Up exercise of the trainees on Basic First Responders Training Course. http://t.co/vdbj2o0IYX,18,['first responders'],1,1,0,17,first responders,0
"SPD OFFICER SHOT - PLEASE PRAY

Please pray for the Shreveport Police Department and other first responders... http://t.co/Kx1YnSME5T",21,['first responders'],1,1,0,20,first responders,1
Red Cross arrived on the scene around 9:30pm to canteen for first Responders fighting this massive blaze. Go... http://t.co/IDY9KsCaVV,23,"['arrived', 'canteen', 'fighting', 'Go']",4,1,0,22,first responders,1
Kirsten Gillibrand http://t.co/amEA3LaMDj    Extend Health Care To 911 First RESPONDERS !,13,['first responders'],1,1,0,12,first responders,0
'We Can Help' Says Denver Firefighter Working To Curb First Responder Suicide http://t.co/aVV6hPNpch,16,['first responders'],1,1,0,15,first responders,0
Allergan Kicks off REFRESH AMERICA Program to Supply First Responders With Free Eye Drops http://t.co/0OjKuLqO5I http://t.co/wkmcPmCtgu,20,['first responders'],1,1,0,19,first responders,0
@IAFFLocal4416 no lives lost except those of first responders or the public they're charged with protecting?,19,"['lives', 'lost', ""'re"", 'charged', 'protecting']",5,1,0,18,first responders,0
Every time I get on the news I see more sadness and needless death. To all my first responders still on shift tonight go home safe. ??????????,38,"['get', 'see', 'go']",3,1,0,37,first responders,0
At the #999day Emergency Services display! Meeting the brave police firefighters and first responders that help keep us safe! ????????,30,"['Meeting', 'help', 'keep']",3,1,0,29,first responders,0
This week first responders and DART members are participating in a four day intensive Technical Large Animal... http://t.co/tL93AOd3ER,21,"['are', 'participating']",2,1,0,20,first responders,0
As firefighters make gains on #RockyFire Jerry Brown is heading to the area to meet with first responders tomorrow morning,21,"['make', 'is', 'heading', 'meet']",4,1,0,20,first responders,1
After shooting event at the theater @Starbucks is giving FREE COFFEE to all first responders police &amp; firefighters. AntiochHickoryHollow#TN,25,"['shooting', 'is', 'giving', 'police', 'amp']",5,1,0,24,first responders,1
New Giant Flames (GIANT FULL BLACK PANTOFEL) info/order sms:087809233445 pin:23928835 http://t.co/dthNEezupe  pic.twitter.com/pNPiZoDY,16,['flames'],1,1,0,15,flames,0
flames everywhere ???? https://t.co/cG9GAkbPta,9,['flames'],1,1,0,8,flames,1
the fires of hell for Julie #Extant writers....she better go down in flames when this is all over...#Extant,24,"['go', 'is']",2,16,15,8,flames,0
@gilderoy i wish i was good enough to add flames to my nails im on fire,17,"['wish', 'was', 'add', 'im']",4,11,10,6,flames,0
@TadhgTGMTEL dude was just smoking and the fucking thing went up in flames i though a bomb went off omg scared,22,"['was', 'went', 'i', 'went', 'scared']",5,14,13,8,flames,0
Maryland mansion fire that killed 6 caused by damaged plug under Christmas tree report says - Into the flames... http://t.co/ucUDwIU3aN,23,"['killed', 'caused', 'damaged', 'tree', 'says']",5,19,18,4,flames,0
├½Ôûê┬ñYou see the devastation &amp; it├½Ôûê┬¼s shocking.├½Ôûê┬ñ  Firefighters continue to battle flames in California. benstracy reports ├½Ôûê_,20,"['see', 'continue']",2,14,13,6,flames,1
watching it go up in flames,6,"['watching', 'go']",2,6,5,0,flames,1
RP said they can see smoke coming from the silo on 260th Street in Hartford but no flames.,19,"['said', 'see', 'coming']",3,18,17,1,flames,1
Maryland mansion fire that killed 6 caused by damaged plug under Christmas tree report says - Into the flames: Firefighter's bravery...,24,"['killed', 'caused', 'damaged', 'tree', 'says']",5,19,18,5,flames,0
Maryland mansion fire that killed 6 caused by damaged plug under Christmas tree report says - Into the flames... http://t.co/P1WmkXA9d8,23,"['killed', 'caused', 'damaged', 'tree', 'says']",5,19,18,4,flames,0
@selmoooooo @_edvinnn @imTariik @dzafic_haris selmo u not catching flames from me  im just gonna be witnessing the slaughter,23,"['catching', 'im', 'gon', 'be', 'witnessing']",5,13,12,10,flames,1
@AisuMage @AkumaReisu --just between Gray and Ophelia red flames blazing around her person setting nearly everything in the area--,23,"['red', 'blazing', 'setting']",3,12,11,11,flames,0
SoloQuiero Maryland mansion fire that killed 6 caused by damaged plug under Christmas tree report says - Into the flames: Firefighte...,23,"['killed', 'caused', 'damaged', 'tree', 'says']",5,20,19,3,flames,0
Maryland mansion fire that killed 6 caused by damaged plug under Christmas tree report says - Into the flames... http://t.co/lKJFabQzb3,23,"['killed', 'caused', 'damaged', 'tree', 'says']",5,19,18,4,flames,0
70 years ago the first atomic attack flattened #Hiroshima 3 days later it was #Nagasaki both war crimes to put Moscow in its place,26,"['flattened', 'was', 'put']",3,8,7,18,flattened,0
Today (August 6th) is the 70th anniversary of A-Bomb 'Little Boy' been dropped on Hiroshima.70000 killed outright as the city was flattened,25,"['is', 'been', 'dropped', 'killed', 'was', 'flattened']",6,25,24,0,flattened,0
@GrabakaHitman @Izi_Garcia when he flattened machida...did he lose that fight..nope he lost fights to guys he shouldn't of lost to also,26,"['flattened', 'did', 'lose', 'lost', 'lost']",5,7,6,19,flattened,0
Flattened thee striker,3,['Flattened'],1,1,0,2,flattened,0
Flattened via IDEAS IN FOOD - A cheesecake brownie does not always have the aesthetic we are ... http://t.co/oRSmW5Airj,21,"['Flattened', 'does', 'have', 'are']",4,1,0,20,flattened,0
@SatanaOfHell ever seen by far. A dreamy look came over his face and his ears flattened as he started to walk slowly toward her.* You'd-,29,"['seen', 'came', 'flattened', 'started', 'walk']",5,18,17,11,flattened,0
Spot Flood Combo 53inch 300W Curved Cree LED Work Light Bar 4X4 Offroad Fog Lamp - Full re├½Ôûê_ http://t.co/E6BnWxFtkb http://t.co/Ww2uVHRy89,24,['flood'],1,1,0,23,flood,0
JKL cancels Flash Flood Warning for Bell Harlan Knox [KY]  http://t.co/4rY6zhcPOQ #WX,17,['flood'],1,1,0,16,flood,1
Spot Flood Combo 53inch 300W Curved Cree LED Work Light Bar 4X4 Offroad Fog Lamp - Full re├½Ôûê_ http://t.co/xxkHjySn0p http://t.co/JEVHKNJGBX,24,['flood'],1,1,0,23,flood,0
A [small] flood with big├òÔò®consequences https://t.co/CVPdVHxd1R http://t.co/FDMXP4FcMo,13,['flood'],1,5,4,8,flood,1
If you decide to get rid of #flood damaged #furniture solid waste will pick it up for a fee. You can call #Tampa Solid Waste at 813-274-8811,31,"['decide', 'get', 'damaged', 'pick', 'call']",5,9,8,22,flood,0
Homecoming Queen Killed on Way Home from the Prom by Flood Waters! #socialnews http://t.co/VmKexjTyG4,18,['Homecoming'],1,1,0,17,flood,0
2 NNW Hana [Maui Co HI] COUNTY OFFICIAL reports COASTAL FLOOD at 5 Aug 10:00 AM HST -- WAIANAPANAPA STATE PARK CLOSED DUE TO LARGE SURF. ├½Ôûê_,30,['flood'],1,1,0,29,flood,1
Flood Advisory issued August 05 at 4:35PM EDT by NWS http://t.co/fuZ7y44P4I #WxKY,15,['issued'],1,1,0,14,flood,1
2pcs 18W CREE Led Work Light  Offroad Lamp Car Truck Boat Mining 4WD FLOOD BEAM - Full rea├½Ôûê_ http://t.co/0AIV5KhZjv http://t.co/q6HHZbFxCv,24,['flood'],1,1,0,23,flood,0
And please don't flood poor @RobertBEnglund's mentions. He's put in his work!,18,"['please', 'do', 'flood', ""'s"", 'put']",5,5,4,13,flood,0
2pcs 18W CREE Led Work Light  Offroad Lamp Car Truck Boat Mining 4WD FLOOD BEAM - Full rea├½Ôûê_ http://t.co/ApWXS5Mm44 http://t.co/DS76loZLSu,24,['flood'],1,1,0,23,flood,0
iembot_hfo : At 10:00 AM 2 NNW Hana [Maui Co HI] COUNTY OFFICIAL reports COASTAL FLOOD #├½Ôûê_ http://t.co/Gg0dZSvBZ7) http://t.co/kBe91aRCdw,27,['flood'],1,1,0,26,flood,1
Internet basics: the flood defective intertissue is soul mate the milk trench host: GUAbxFv http://t.co/uzsQzYcB8X,19,['is'],1,5,4,14,flood,0
BMX issues Areal Flood Advisory for Shelby [AL] till Aug 5 9:00 PM CDT http://t.co/62OddEkVLi,19,['flood'],1,1,0,18,flood,0
How did I know as soon as I walked out of class that Calgary would flood again today,18,"['did', 'know', 'walked', 'flood']",4,16,15,2,flood,0
Flood Advisory in effect for Shelby County in AL until 9 PM #alwx http://t.co/gTqMGsgcsB,17,['flood'],1,1,0,16,flood,1
RT grant_factory: #grants #funds Weymouth meeting on seawalls and flood grants set for Thursday night ├½Ôûê_ http://t.co/Th2WLilBmo,22,['set'],1,13,12,9,flood,0
12' 72W CREE LED Work Light Bar Alloy Spot Flood Combo Diving Offroad 4WD Boat - Full read├½Ôûê_ http://t.co/8Mk9TD4RRL http://t.co/W20rH3Ai9J,25,['flood'],1,1,0,24,flood,0
Flood Advisory issued August 05 at 4:28PM EDT by NWS http://t.co/D02sbM0ojs #WxKY,15,['issued'],1,1,0,14,flood,1
Myanmar Flood Victims Need More Relief Aid and Food: Regions struggle with flood aftermath and dwindling suppl... http://t.co/O5adXdNnII,22,"['struggle', 'dwindling']",2,14,13,8,flood,1
Flood Prone Waterways In Westchester County Now Eligible For Millions In State Aid #NewYork - http://t.co/XSR2VUJyIz,19,['flood'],1,1,0,18,flood,1
Chinese rescue team arrives in Myanmar to help flood victims http://t.co/nOSvu0Zx4x Sittway http://t.co/5mJZJNkPfn,17,"['arrives', 'help']",2,9,8,8,flood,1
"Flash Flood Watch in effect through 7:00am Thursday morning/12:00pm Thursday afternoon.
For: Perry Wayne Cape... http://t.co/fs7vro5seS",21,['morning/12:00pm'],1,1,0,20,flood,1
12' 72W CREE LED Work Light Bar Alloy Spot Flood Combo Diving Offroad 4WD Boat - Full read├½Ôûê_ http://t.co/EBJz2MxLr3 http://t.co/jvVD8smJMw,25,['flood'],1,1,0,24,flood,0
Flood Advisory issued August 05 at 7:10PM CDT until August 05 at 8:00PM CDT by NWS: ...THE URBAN AND ... http://t.co/SeMw5cQ7Dg #weather,27,['issued'],1,1,0,26,flood,1
ROCK SPRINGS ├½Ôûê├è Residents living off Elk Street continue to battle flooding issues after Monday├½Ôûê┬¼s rain storm. While├½Ôûê_ http://t.co/8J19FvU7qA,22,"['living', 'continue', 'flooding']",3,12,11,10,flooding,1
Cuban leader extends sympathy to Vietnam over flooding at http://t.co/xLq8G6vb2r,12,"['extends', 'flooding']",2,8,7,4,flooding,0
Business at the Sponge Docks washed out by rain flooding: http://t.co/5PmikAVyKL,14,['washed'],1,10,9,4,flooding,1
Memorial unveiled for Travis County Deputy Jessica Hollis who was killed in Sept. flooding http://t.co/uSiN3M9kgI http://t.co/Mo5lmviPw5,20,"['unveiled', 'was', 'killed', 'flooding']",4,14,13,6,flooding,0
Severe Thunderstorms and Flash Flooding Possible in the Mid-South and Midwest http://t.co/uAhIcWpIh4 #WEATHER #ENVIRONMENT #CLIMATE #NATURE,22,['flooding'],1,1,0,21,flooding,1
11:30a Radar Update: Widespread Showers/Storms but moving over the same areas-minor flooding possible #HUNwx http://t.co/E3L1JqjH2u,19,['moving'],1,13,12,6,flooding,1
Flooding ???? http://t.co/WVeO9ED10e,8,['Flooding'],1,1,0,7,flooding,1
Flooding kills 166 displace over one million in Pakistan - Daily News &amp; Analysis http://t.co/9mj8oUj3vt #yugvani,21,['Flooding'],1,1,0,20,flooding,1
Awh damn  I just realized yall gone flooding my TL with school shit and Ima be like .. ??,20,"['realized', 'gone', 'be']",3,8,7,12,flooding,0
Flooding kills 166 displace over one million in Pakistan - Daily News &amp; Analysis http://t.co/KkOOVBKndp,19,['Flooding'],1,1,0,18,flooding,1
#Laos flooding -10 villages underwater World Vision responding http://t.co/8fvQRizOUX,12,"['flooding', 'responding']",2,3,2,9,flooding,1
#floods #ukfloods - British trekkers rescued amid flash floods in Himalayas: A group of British tr... http://t.co/nsfzkfgZnj - #flooding,26,['rescued'],1,26,25,0,flooding,1
Cuban leader extends sympathy to Vietnam over flooding at http://t.co/QcyXwr2rdv,12,"['extends', 'flooding']",2,8,7,4,flooding,0
#NYCHA says the pipe that burst and flooded apartments in a senior center is being repaired. http://t.co/eCyui3290H http://t.co/6S6sYUYypL,24,"['says', 'flooded', 'is', 'being', 'repaired']",5,1,0,23,flooding,1
"When the waves are flooding the shore
And I can't find my way home anymore
That's when I look at you http://t.co/TDAKtGlU5p",26,"['are', 'flooding', 'find', ""'s"", 'look', 'http']",6,5,4,21,flooding,0
If Flooding occurs in your home - How to stop mold growth via @ProudGreenHome http://t.co/KAVAovJz2V,18,"['occurs', 'stop']",2,1,0,17,flooding,0
http://t.co/XJkRXrNWNv Flooding of tracks caused derailment sa #INSubcontinent @INSubcontinent http://t.co/JlWGshYY3N,16,['caused'],1,1,0,15,flooding,1
Obama Keeps 27 Iraqi Christian Asylum Seekers nDetention While Flooding U.S. w/Unscreened Muslims: http://t.co/b4k0R4GgA8 via @DCClothesline,20,"['Flooding', 'w/Unscreened']",2,1,0,19,flooding,1
#BREAKING Business at the Sponge Docks washed out by rain flooding  /#news,15,"['washed', 'flooding']",2,12,11,3,flooding,1
Nigeria warned against massive├òÔò®flooding http://t.co/CofH4khFsD http://t.co/m0fLpPxIlg,10,"['warned', 'massive├òÔò®flooding']",2,1,0,9,flooding,1
So grateful for all the support flooding in from @NetkiCorp dinner guests! THANK YOU ALL! https://t.co/ELTne5v1Qn,21,['flooding'],1,7,6,14,flooding,0
"Flooding updates from Pasco County

http://t.co/gOSzRa5bdD",8,['Flooding'],1,1,0,7,flooding,1
There some flash flooding in madison #valleywx,8,['flooding'],1,4,3,4,flooding,1
Donate to help Myanmar Flooding victims http://t.co/fuRVRES9Ks,9,['help'],1,1,0,8,flooding,0
├½Ôûê┬ñ@BBCEngland: A burst water main causes major flooding at a Birmingham hospital http://t.co/q4kGftC2AM http://t.co/6w6A2L4qAe├½Ôûê├ÿ OMG.,23,['flooding'],1,11,10,12,flooding,1
Heavy Rainfall and Flooding in Northern #VietNam | Situation Report No.2 http://t.co/hVxu1Zcvau http://t.co/iJmCCMHh5G,18,['flooding'],1,1,0,17,flooding,1
#flood #disaster Burst Water Pipe Floods Apartments at NYCHA Senior Center - NY1: NY1Burst Water Pipe Floods A... http://t.co/w7SIIdujOH,25,['flooding'],1,1,0,24,flooding,1
Myanmar: MSF assisting thousands as worst flooding in decades hits parts of Myanmar http://t.co/PiJG5w2L2u,17,"['assisting', 'flooding']",2,8,7,9,flooding,1
Residents in the central part of Ocean City heard from engineers about flood mitigation options Tuesday #OCNJ... http://t.co/jzPrCIqa9D,22,['flooding'],1,1,0,21,flooding,1
Monsoon Flooding Kills Dozens In Myanmar Prompting Calls For Help - http://t.co/r7vPaKlhvI,14,['flooding'],1,1,0,13,flooding,1
Memorial unveiled for Travis County deputy killed in Sept. flooding: Travis County Sheriff Greg Hamilton joined├½Ôûê_ http://t.co/Eo2F96WXPz,20,"['unveiled', 'killed']",2,10,9,10,flooding,0
"Flooding kills 166 displace over one million in Pakistan http://t.co/iCFQl7I9oP

At least 166 people have been killed and nearly 11 lakh├½Ôûê_",23,"['Flooding', 'have', 'been', 'killed']",4,1,0,22,flooding,1
"Who is bringing the tornadoes and floods. Who is bringing the climate change. God is after America He is plaguing her
 
#FARRAKHAN #QUOTE",27,"['is', 'bringing', 'is', 'bringing', 'is', 'is', 'plaguing']",7,7,6,20,floods,0
Myanmar Flooding: Heavy monsoon rains during the month of July have caused flooding flash floods and landsli... http://t.co/9TG7A5OqFP,22,"['have', 'caused']",2,16,15,6,floods,0
In #India 119000 people have taken shelter in the 966 relief camps the government has set up after the #floods:   http://t.co/eU8jypIzsd,26,"['have', 'taken', 'has', 'set']",4,22,21,4,floods,0
@pmharper don't worry I'm sure climate has nothing to do with hail floods tornados in Alberta &amp; Ontario. I'm sure god's just mad at you.,34,"['do', 'worry', ""'m"", 'has', 'do', 'tornados', ""'m""]",7,16,15,18,floods,0
Pasco officials impressed by drone video showing floods: Drone videos have given an up-close view of flooded areas├½Ôûê_ http://t.co/PrUunEDids,22,"['impressed', 'showing', 'have', 'given']",4,8,7,14,floods,0
"@ictyosaur I never thought it would be a wtf moment yet it's here after months of 90 degree heat
Next we will have flash floods..",27,"['thought', 'be', ""'s"", 'have', 'flash']",5,27,26,0,floods,0
Granted like half my town floods when it rains but still whatever,12,"['Granted', 'rains']",2,6,5,6,floods,1
@Cyberdemon531 i hope that mountain dew erodes your throat and floods your lungs leaving you to drown to death,20,"['hope', 'leaving', 'drown']",3,12,11,8,floods,0
Disaster group stunned by floods http://t.co/jrgJ17oAMt,8,['stunned'],1,5,4,3,floods,1
#flood #disaster Bengal floods: CM Mamata Banerjee blames DVC BJP claims state failed to use ... - Economic T... http://t.co/BOZlwr716Z,26,"['blames', 'claims', 'failed', 'use']",4,6,5,20,floods,0
69 Dead Due to Floods in Myanmar: Naypyidaw Aug 5 (Prensa Latina) The death toll rose today to 69 in Myanmar... http://t.co/JoDs9a32PI,28,['rose'],1,1,0,27,floods,0
"@asgharchohan86 @AdilGhumro 
There are floods in kpk because you guys couldn't build dams in 30 years you ruled.
Even for your own Thar",27,"['are', 'build', 'ruled']",3,7,6,20,floods,0
"Who is bringing the tornadoes and floods. Who is bringing the climate change. God is after America He is plaguing her
 
#FARRAKHAN #QUOTE",27,"['is', 'bringing', 'is', 'bringing', 'is', 'is', 'plaguing']",7,7,6,20,floods,0
Typhoon Soudelor approaches after 7 killed 2 missing in floods in Philippines http://t.co/nJMiDySXoF via @abc7chicago,18,"['killed', 'missing']",2,10,9,8,floods,0
"If I wouldn't have lost all my guns in #Colorado floods I would say I could completely understand
#copolitics #2A https://t.co/37rHlsobbn",27,"['have', 'lost', 'say', 'understand']",4,13,12,14,floods,0
@casewrites when it rains in NJ it flash floods. Otherwise its just a desert of grief and taxes.,21,"['rains', 'flash', 'Otherwise']",3,10,9,11,floods,0
@ContactEnergy Yep. During floods of 1999 or 2000 - Clyde Dam releasing every bit of water it could. Most speccy!  EV charging your way?,29,"['releasing', 'charging']",2,6,5,23,floods,0
Bamenda Floods Kill Animals Birds - http://t.co/WnamtxlfMt http://t.co/6cOIDv11qV,12,['floods'],1,1,0,11,floods,0
APC Chieftain Tasks Dickson On N15b Floods Donation To Bayelsa http://t.co/LqGOe7psXp,13,['floods'],1,1,0,12,floods,0
PAGASA 7:12am: YELLOW warning - Panay Island Guimaras Negros. Possible floods in low-lying areas &amp; landslides in mountainous areas.,24,['warning'],1,13,12,11,floods,0
RT: 40HourFamine: In #Bangladesh government has not declared floods an emergency. #WorldVision will continue to m├½Ôûê_ http://t.co/XqdVghz8G6,24,"['has', 'declared', 'continue', 'm├½Ôûê_']",4,12,11,12,floods,0
Nearly 50 thousand people affected by floods in #Paraguay ? http://t.co/aw23wXtyjB http://t.co/ABgct9VFUa,17,['affected'],1,7,6,10,floods,1
ETP Bengal floods: CM Mamata Banerjee blames DVC BJP claims state failed to use relief funds: Even as flood w... http://t.co/hsZjaFxrvi,26,"['blames', 'claims', 'failed', 'use']",4,3,2,23,floods,0
May Allah help all those suffering from the #Pakistan floods! You and your families are in our #Dua,21,"['suffering', 'are']",2,11,10,10,floods,0
Children in Myanmar face a 'double catastrophe' as floods hit the most ... http://t.co/0jFNvAXFph,17,"['face', 'hit']",2,10,9,7,floods,0
Typhoon Soudelor approaches after 7 killed 2 missing in floods in Philippines http://t.co/hALJNnWrwi via @abc7chicago,18,"['killed', 'missing']",2,10,9,8,floods,1
Flash floods landslides possible as Hanna draws in more monsoon rains - Pagasa http://t.co/TzWmsEQPHW | via News5 #iBalita,21,"['landslides', 'draws', 'rains']",3,2,1,19,floods,1
I'm so dried out in this desert let me know I wanna be with you speaking of floods speaking of truth - Laleh ????????,33,"[""'m"", 'dried', 'let', 'know', 'wan', 'be', 'speaking', 'speaking']",8,20,19,13,floods,0
Myanmar floods occur during low season for river cruising - Pandaw River Expeditions is currently operating only t... http://t.co/cQtTGrkwf6,22,"['occur', 'cruising', 'is', 'operating']",4,2,1,20,floods,0
69 die in Myanmar floods 250000 affected http://t.co/LxjjGyv86A | https://t.co/U9x3perXCO,14,['floods'],1,5,4,9,floods,1
Typhoon Soudelor approaches after 7 killed 2 missing in floods in Philippines├½Ôûê_ http://t.co/8rDXcfgQEm #Typhoon,17,"['killed', 'missing']",2,10,9,7,floods,1
Memphis always floods,3,['floods'],1,3,2,0,floods,0
Floods cause damage and death across Asia | All media content | http://t.co/a2myUTpDiQ | 05.08.2015 http://t.co/XrSkT0s9lz,20,['cause'],1,1,0,19,floods,0
#WorldVision is responding to floods in #India and #MyanmarFlood with more than 300000 affected: http://t.co/eU8jypIzsd,21,"['is', 'responding']",2,6,5,15,floods,0
Bengal floods: CM Mamata Banerjee blames DVC BJP claims state failed to use relief funds: KOLKATA: Even as fl... http://t.co/WFwWRcmi9t,26,"['blames', 'claims', 'failed', 'use']",4,2,1,24,floods,0
E1.1.2 Particulate=Break up of Solid Combust Fossil Fuel Voltaic Active Forest Fire Biological VOC=Petroleum CH4 Bacteria Decomposition,17,['forest fire'],1,1,0,16,forest fire,1
BE CAREFUL anyone who lives west of Beaverton. Forest Grove has a rapidly spreading fire heading east,18,"['lives', 'has', 'spreading']",3,1,0,17,forest fire,1
I added a video to a @YouTube playlist http://t.co/bcjYleRRYX Ori and the Bind forest ep 6 'Fire and death',23,['added'],1,1,0,22,forest fire,0
How is it one careless match can start a forest fire but it takes a whole box to start a campfire?,22,"['is', 'start', 'takes', 'start']",4,1,0,21,forest fire,0
Our little forest fire wardens http://t.co/aPreNsss3x,8,['forest fire'],1,1,0,7,forest fire,0
Fire in Pisgah National Forest grows to 375 acres http://t.co/d7zxZ42QW1,12,['grows'],1,1,0,11,forest fire,1
Ashenforest floorburnt manzanita &amp; timber on Johnson Fire along ridge on Forest Road 1. #RouteComplex http://t.co/FYMP4I2Wp5,22,['timber'],1,1,0,21,forest fire,1
Grass fire near Forest Grove contained. Sparked by a rock being struck by a tractor. #LiveOnK2 @JackieKATU http://t.co/Yr9mmIS7jT,24,"['contained', 'Sparked', 'being', 'struck']",4,1,0,23,forest fire,1
@Sweet2Young -runs at her for setting my forest on fire and bites the shit out of her neck-,19,"['-runs', 'setting', 'bites']",3,1,0,18,forest fire,0
@hornybigbadwolf -sets the forest on fire-,7,['-sets'],1,1,0,6,forest fire,1
View of smoke column rising above the south end of the Blake Fire along Forest Road 1. #RouteComplex http://t.co/Yqg5Pvw5gX,23,['rising'],1,1,0,22,forest fire,1
Damn dry desert forest fire...damn :( https://t.co/P5SoDrkVW3,12,['forest fire'],1,1,0,11,forest fire,1
IT STARTS A FOREST FIRE THAT CANNOT BE PUT OUT. http://t.co/3STfmN26r9,15,"['STARTS', 'PUT']",2,1,0,14,forest fire,1
#Winston #salem Fire in Pisgah National Forest grows to 375 acres http://t.co/5IMxNGsaSA,16,['grows'],1,1,0,15,forest fire,1
Fire in Pisgah National Forest grows to 375 acres http://t.co/dao9AZEUcr,12,['grows'],1,1,0,11,forest fire,1
Crews responding to small brush fire burning in Tahoe Forest - My News 4 - KRNV Reno NV http://t.co/VhyJnVug6f,21,['responding'],1,1,0,20,forest fire,1
5:15p For those who watch over me forest fire smoke has lifted 'nuff f/me t/make a run t/the pet store on the hwy (N). I'll b/home by 7p.,33,"['watch', 'has', 'lifted', 't/make', 'b/home']",5,1,0,32,forest fire,1
We are having forest fires out here in #socal but the only fire you should watch for is @YBTheProphet #RealHiphop https://t.co/ZPSnX5iYAJ,26,"['are', 'having', 'watch', 'is']",4,1,0,25,forest fire,1
OMG there's a news chopper over a 3-acre mostly contained fire outside Forest Grove? #slownewsday ?,19,"[""'s"", 'contained']",2,1,0,18,forest fire,1
U.S. Forest Service firefighter David Ruhl 38 died in the 'Frog Fire' in the Modoc National Forest. He had been temporarily reassigned,24,"['died', 'had', 'been', 'reassigned']",4,1,0,23,forest fire,1
#GlobalWarming U.S. Forest Service says spending more than half of budget on fires: ├½Ôûê_  United States the agen...  http://t.co/mWiE5CeEIi,24,"['GlobalWarming', 'says']",2,1,0,23,forest fires,0
Only you can prevent forest fires. ???? http://t.co/rGYUaKc0dR,14,['prevent'],1,1,0,13,forest fires,0
#Reuters #US Forest #Service says spending more than half of budget on fires http://t.co/XlpgKguhkG,19,['says'],1,1,0,18,forest fires,0
#NaturalDisasters As California fires rage the Forest Service sounds the alarm about rising wildfire costs: ├½Ôûê_...  http://t.co/TQwrW3jQWo,22,"['fires', 'rage', 'sounds', 'rising']",4,1,0,21,forest fires,0
Why can't they use ocean water to fight forest fires? http://t.co/NMWi5Sm3Uw,15,"['use', 'fight']",2,1,0,14,forest fires,0
As California fires rage Forest Service sounds the alarm about sharply rising wildfire costs http://t.co/dFYrPpzkPu http://t.co/iwsdbGd1zq,20,"['fires', 'rage', 'sounds', 'rising', 'http']",5,1,0,19,forest fires,1
A little concerned about the number of forest fires where I'll be living,14,"['be', 'living']",2,1,0,13,forest fires,0
@nycdivorcelaw TRUMP IS A CLIMATE DENIER- algae bloom in the pacific from calif to alska- seeweed in caribean forest fires- SNOWBALL INHOFE,23,['IS'],1,1,0,22,forest fires,0
The forest service now spends &gt;50% of its budget fighting fires http://t.co/SrSLCxHc2T,18,"['spends', 'http']",2,1,0,17,forest fires,0
People come and go. Some are cigarette breaks others are forest fires.,14,"['come', 'go', 'are', 'are']",4,1,0,13,forest fires,0
@lldubs Are any of your vineyards affected by the forest fires in California?,15,"['Are', 'affected']",2,1,0,14,forest fires,0
This is the first year the Forest Service spent more than half its annual budget on fighting fires. #climatechange http://t.co/D62zfZy0Mi,24,"['is', 'spent', 'fighting']",3,1,0,23,forest fires,0
As California fires rage the Forest Service sounds the alarm about rising wildfire costs http://t.co/Tft1bb4xaZ,17,"['fires', 'rage', 'sounds', 'rising', 'http']",5,1,0,16,forest fires,0
Reddit: http://t.co/UtuMVaABz6 Lightning sparks new fires in Boise National Forest /r/StormComing,14,"['Lightning', '/r/StormComing']",2,1,0,13,forest fires,1
The spread of Conflict #PalmOil has sparked an increase in fires destroying #forest throughout #Indonesia http://t.co/4zn0MDsRVp,21,"['has', 'sparked', 'destroying']",3,1,0,20,forest fires,0
I hope the rain stops the forest fires tbh we've been on lvl. 3 lockdown for water for the past month :/,25,"['hope', 'stops', 'tbh', ""'ve"", 'been']",5,1,0,24,forest fires,0
Stubborn forest fires burn in two provinces |RZ| http://t.co/yZO948652k #Iran #IranElection,15,['burn'],1,1,0,14,forest fires,1
Photo: blue by @forest.fires source: http://t.co/awXR24zsqh http://t.co/o9A26Fn27y,14,['forest fires'],1,1,0,13,forest fires,0
Forest fires &amp; dying salmon: time 2 act not deny. Climate Change Nightmares Are  Here http://t.co/RBZomWGjeE #bcpoli #canpoli #vanpoli,28,"['fires', 'dying', 'deny', 'http']",4,1,0,27,forest fires,0
Worth the read --&gt; As California fires rage the Forest Service sounds the alarm about sharply rising wildfire costs http://t.co/2LZtOMsAUz,25,"['fires', 'rage', 'sounds', 'rising', 'http']",5,1,0,24,forest fires,0
A group of Florida Forest Service firefighters could be deployed to California to help contain fires. Details at 10! http://t.co/tRrig5J1Re,24,"['be', 'deployed', 'help', 'contain']",4,1,0,23,forest fires,1
"8-5-2015 - 4:30 P.M. - Progress Being Made on Boise Forest Fires
http://t.co/6o1mgMGHgt http://t.co/wTPO6elRZd",18,['Made'],1,1,0,17,forest fires,0
A group of Florida Forest Service firefighters could be deployed to California to help contain fires. Details at 10! http://t.co/fwuP9YURzY,24,"['be', 'deployed', 'help', 'contain']",4,1,0,23,forest fires,1
PRAY! For EAST COAST FOREST FIRES! PRAY! That they be put out. PRAY! For RAIN!,21,"['be', 'put']",2,1,0,20,forest fires,0
@BlueJays @Braves @Angels Instead of dumping water on yourselves please send it to British Columbia to help with the forest fires,24,"['dumping', 'please', 'send', 'British', 'help']",5,1,0,23,forest fires,0
Property losses from northern CA wildfire nearly double http://t.co/fHqx7FiIVJ If you pray please remember CA people/forests/wildlife/water,18,"['pray', 'please', 'remember']",3,1,0,17,forest fires,0
#HeartDisease U.S. Forest Service says spending more than half of budget on fires http://t.co/KzfiGkEeva,17,['says'],1,1,0,16,forest fires,0
Two New Bitterroot National Forest Fires are Largest for Forest So Far This Year http://t.co/zVa34qHU8M,17,['are'],1,1,0,16,forest fires,0
CLIMATE CONSEQUENCES: U.S. Forest Service Says Spending More Than Half Of Budget On Fires http://t.co/k0QtL8aODH http://t.co/zQBXe7x9Y7,21,['Says'],1,1,0,20,forest fires,0
Standing in mountaintop field scented with wildflowers dust and distant forest fires smell of impending rain in the air.  #fieldworksmells,22,"['Standing', 'scented', 'dust', 'smell', 'impending']",5,1,0,21,forest fires,0
U.S. Forest Service says spending more than half of budget on fires http://t.co/1hLVrKwgIP,15,['says'],1,1,0,14,forest fires,0
Property losses from northern California wildfire nearly double http://t.co/oTfW5SEkD7 via @YahooNews,14,['forest fires'],1,1,0,13,forest fires,0
Inciweb OR Update:  Rogue River-Siskiyou National Forest Fires  8/5/15 12:00 PM (Rogue River-Siskiyou NF Area├½Ôûê_ http://t.co/LkwxU8QV7n,20,['Fires'],1,1,0,19,forest fires,1
Forest fires could delay @AbbyAirshow but officials say it could be a good thing http://t.co/Vxjcx8uKMd,18,"['delay', 'say', 'be']",3,1,0,17,forest fires,0
Firefighting consumes Forest Service budget sparks political clash http://t.co/ARN8qfgNpm,11,"['Firefighting', 'sparks']",2,1,0,10,forest fires,0
U.S. Forest Service says spending more than half of budget on fires: By Ian Simpson├½Ôûê_ http://t.co/UyYYrKd6q3,19,['says'],1,1,0,18,forest fires,0
"Campsite recommendations 
Toilets /shower 
Pub 
Fires 
No kids 
Pizza shop 
Forest 
Pretty stream 
No midges
No snakes
Thanks ??",20,"['stream', 'midges']",2,1,0,19,forest fires,0
When ur friend and u are talking about forest fires in a forest and he tells u to drop ur mix tape out there... #straightfire,27,"['are', 'talking', 'tells', 'drop']",4,1,0,26,forest fires,0
Firefighting consumes Forest Service budget sparks political clash: Forest Service report cites increasing cost of├½Ôûê_ http://t.co/lSWsitnkuk,19,"['Firefighting', 'sparks', 'cites', 'increasing']",4,1,0,18,forest fires,0
@froilan_canin https://t.co/caCXADLEb8 AFTERNOON DELIGHT Ha! Bounce filmed in between Calgary's Uber Hail Storms #yyc http://t.co/6zgkDpMMSK,23,['filmed'],1,1,0,22,hail,0
BYZ issues Severe Thunderstorm Warning [wind: 60 MPH hail: 1.00 IN] for Big Horn Yellowstone [MT] till Aug 5 8:00 PM MDT  ├½Ôûê_,29,['hail'],1,11,10,18,hail,0
Hvy rain wind sm hail Tree down on Bluff Ridge Rd. Multiple trees down o on house on South Shades Crest Rd. (Past Lake Drive) @spann,31,"['trees', '@']",2,5,4,26,hail,1
"GREAT MICHIGAN TECHNIQUE CAMP
B1G THANKS TO @bmurph1019 
@hail_Youtsey . @termn8r13 
#GoBlue #WrestleOn http://t.co/OasKgki6Qj",21,['hail'],1,11,10,10,hail,0
All Hail Shadow (Hybrid Mix Feat. Mike Szuter): http://t.co/9e2f7bIvlE @youtube ##youtube,20,['hail'],1,1,0,19,hail,0
LZK issues Severe Thunderstorm Warning [wind: 60 MPH hail: 0.75 IN] for Sharp [AR] till 8:15 PM CDT  http://t.co/AUXSMdG1uN #WX,29,['till'],1,11,10,18,hail,1
Strong Thunderstorm 4 Miles North of Japton Moving SE At 25 MPH. Large Hail and Wind Gusts Up to 50 MPH Poss... #arwx http://t.co/TIM8x9bI0f,29,['Gusts'],1,1,0,28,hail,1
RNK issues Severe Thunderstorm Warning [wind: 60 MPH hail: 1.00 IN] for Rockingham Stokes [NC] till Aug 5 10:00 PM EDT  ├½Ôûê_,28,['hail'],1,11,10,17,hail,1
Cue storm with massive wind and hail!! Now a power outage @WXII in Davidson County.,19,['hail'],1,7,6,12,hail,1
Which version of All Hail Shadow you do you like more Magna-Fi's or Crush 40's? ├½Ôûê├ï Crush 40s. http://t.co/oGs6d0p3RB,25,['do'],1,1,0,24,hail,0
Strong Thunderstorm 4 Miles North of Japton Moving SE At 25 MPH. Large Hail and Wind Gusts Up to 50 MPH Poss... #arwx http://t.co/blppzAIbOE,29,['Gusts'],1,1,0,28,hail,1
Severe Thunderstorm 7 Miles North of Arcadia Moving SE At 20 MPH. 60 MPH Wind Gusts and Large Hail. Hail... #okwx http://t.co/WEd69e4KRg,28,['hail'],1,1,0,27,hail,1
Severe Thunderstorm Warning until 08:00 PM local for Custer Fall River &amp; Shannon Counties in SD. 60 Mph Wind Gusts And Penny Size Hail. #sd,30,['hail'],1,1,0,29,hail,1
@modnao23 the hail is ruining everything. Plus my car I haven't even gotten yet. Have yet another killer migraine and I lost my glasses. ??,31,"['modnao23', 'is', 'ruining', 'have', 'gotten', 'Have', 'lost']",7,4,3,27,hail,1
@adolwyn This near U? @JWagstaffe: RT @OldsFireDept: Aug 5 2015 Hwy27 west of Olds. Approximately 1 foot of hail. http://t.co/Yg0pd73Bpw',31,['hail'],1,26,25,5,hail,1
New warning for Central Hills 1' hail 60 mph winds. NOT affecting Sturgis but could later tonight. #KOTAWeather http://t.co/1EPIYeNQYL,25,"['warning', 'affecting', 'tonight']",3,8,7,17,hail,1
Heavy rain and lightning overhead in Oakridge SW Calgary - at least it will melt the hail......#yycstorm #ABStorm,23,"['lightning', 'melt']",2,17,16,6,hail,1
@HeyItsEpark heavy rain and hail,6,['hail'],1,6,5,0,hail,1
@weathernetwork here comes the hail!,7,['comes'],1,6,5,1,hail,1
i survived what you tried to destroy you're not a man just a boy,15,"['survived', 'tried', 'destroy', ""'re""]",4,1,0,14,hail,0
Central Mass. fruit trees escape heavy damage after wind hail http://t.co/VbFfodtP6M,14,['escape'],1,11,10,3,hail,0
New warning for Central Hills 1' hail 60 mph winds. NOT affecting Sturgis but could later tonight. #KOTAWeather http://t.co/qo3VWFelkp,25,"['warning', 'affecting', 'tonight']",3,8,7,17,hail,1
Calgary pounded with hail on second day of storms https://t.co/2BE7BwcMpl,12,['pounded'],1,4,3,8,hail,0
New warning for Central Hills 1' hail 60 mph winds. NOT affecting Sturgis but could later tonight. #KOTAWeather http://t.co/E8oUxVKuTE,25,"['warning', 'affecting', 'tonight']",3,8,7,17,hail,1
Hi-Res Doppler showing storm just NE of Edmond is now severe with 1.25' hail and 60mph wind possible. #okwx http://t.co/lrx0sDsNHM,25,"['showing', 'is']",2,15,14,10,hail,1
Well so much for outdoor postering @calgaryfringe #mothernature #hailstorm #rain #yycfringe #KILLHARD,18,['postering'],1,12,11,6,hailstorm,0
Twin Storms Blow Through Calgary * 75 http://t.co/sIAKlSbdiP http://t.co/fm44ZS93OA,13,['hailstorm'],1,1,0,12,hailstorm,1
Freak #Boston #hailstorm produces a hailstorm of business ... for auto-body repair specialists. @PeterHoweNECN 6:30/8:30 TONIGHT @necn,22,"['produces', '@']",2,8,7,14,hailstorm,0
OMG NIXON LIVES! That is Richard M. Nixon Tricky Dicky right there in the picture isn't it. Hiding in Calgary he... http://t.co/MIUsvPxQTE,28,"['is', 'is', 'Hiding']",3,1,0,27,hailstorm,0
Boston yesterday after an intense hailstorm. Photo by 'then0mads0ul'. http://t.co/uxgtXCArQ1,15,['hailstorm'],1,6,5,9,hailstorm,0
@AdriaSimon_: Hailstorm day 2.... #round2 #yyc #yycstorm http://t.co/FqQI8GVLQ4,17,['hailstorm'],1,1,0,16,hailstorm,0
~ More wicked weather rolls through Calgary and surrounding areas http://t.co/SxwJyR3K3l http://t.co/aEWGlVqReH,16,['surrounding'],1,1,0,15,hailstorm,1
Gotta love #summer in #Calgary. #yyc #hailstorm #crazyweather http://t.co/xQbWnLBBIu,18,['love'],1,13,12,5,hailstorm,0
Severe weather and a rare hailstorm pummel Boston - http://t.co/jkYM9EdOfc,12,['hailstorm'],1,6,5,6,hailstorm,1
We The Free Hailstorm Maxi http://t.co/ERWs6IELdG,8,['hailstorm'],1,1,0,7,hailstorm,0
Yesterday's #hailstorm! #boston #cambridge http://t.co/HbgYpruvO7 http://t.co/SwtgHLibs2,15,['hailstorm'],1,4,3,11,hailstorm,0
RICHIE: This was #Calgary yesterday after a crazy #hailstorm! pics via Calgary Herald http://t.co/1oH20qHk2l,20,['was'],1,12,11,8,hailstorm,0
Twin Storms Blow Through Calgary ~ 1 http://t.co/rzaGDnWTAH http://t.co/uqEttaGSCU,13,['hailstorm'],1,1,0,12,hailstorm,1
Summer heat drives bobcats to Calgary backyards ~ 35 http://t.co/TmzXopVs94 http://t.co/W192Wkog1M,15,['~'],1,1,0,14,hailstorm,0
Ready for my close up... Errrr nope!! #notgoingoutinthat #hailstorm #alberta @HellOnWheelsAMC @HoW_fans @TalkingHell http://t.co/9gIAXD6JTY,25,['hailstorm'],1,14,13,11,hailstorm,0
Get out of the hailstorm and come down to @TheBrokenCity 2night at 9PM to catch a screening ft. @thebanffcentre! There will be BEER + FOOD!,29,"['Get', 'come', '@', 'catch', 'be']",5,5,4,24,hailstorm,0
IG: http://t.co/2WBiVKzJIP 'It's hailing again! #abstorm #yyc #hail #hailstorm #haildamage #yycweather #calgary #captureyyc #alberta #sto├½Ôûê_,30,['hailstorm'],1,18,17,12,hailstorm,0
It looks like all the trees in my yard had a Britney Spears style meltdown. #Bald #Hailstorm,20,"['looks', 'had']",2,1,0,19,hailstorm,0
Hailstorm flash flooding slam Calgary knocks out power to 20k customers http://t.co/sNpPqrwuXB,14,"['flooding', 'knocks']",2,1,0,13,hailstorm,1
Summer heat drives bobcats to Calgary backyards ~ 3 http://t.co/kEstuUYc4t http://t.co/PzFBb1P1mj,15,['~'],1,1,0,14,hailstorm,0
JPLocalFirst RT eliotschool: Yesterday's #hailstorm in #Boston. Wow. Thunder lightning. Artful awesome. http://t.co/YsvE1SEAko,23,['lightning'],1,8,7,15,hailstorm,0
Sadly the tent fly did not survive this hailstorm and now I have tears in the roof and water in the tent.  Only... http://t.co/zCt5cchOJ0,28,"['did', 'survive', 'have']",3,9,8,19,hailstorm,0
This was Boston yesterday after an intense hailstorm [X-Post from /r/cityporn] [4608Ôòá├É2474] (├½Ôûê_ http://t.co/8E6XuhrBKh http://t.co/Qo190N8UdD,24,['was'],1,8,7,16,hailstorm,0
#yyctraffic #yycstorm  Caller says 'idiots' are stopping under overpasses and blocking 'all lanes on Crowchild' in (small-sized) hailstorm.,25,"['says', 'are', 'stopping', 'blocking']",4,24,23,1,hailstorm,0
here is goes again #abstorm #hailstorm #yychail stay safe everyone!,14,"['is', 'goes']",2,8,7,6,hailstorm,1
"Canada: Hailstorm flash flooding slam Calgary knocks out power to 20k customers
http://t.co/SkY9EokgGB http://t.co/5IyZsDA6xB",19,"['flash', 'flooding', 'knocks']",3,1,0,18,hailstorm,1
Severe hailstorm in progress over Northeast Logan County... #cowx http://t.co/XK9OwGV1O5,14,['hailstorm'],1,2,1,12,hailstorm,1
Hundreds of commuters abandoned at LRT station during severe hailstorm http://t.co/vMIGkJ0tkZ,13,['abandoned'],1,10,9,3,hailstorm,1
Good olde fashioned prairie #hailstorm #calgaryweather https://t.co/hI1yOQFlfm,11,['fashioned'],1,6,5,5,hailstorm,0
@CouncilSCC it does say hailstorm,6,"['does', 'say', 'hailstorm']",3,6,5,0,hailstorm,0
"This is why I am scared to leave my car under trees in a storm

#jamaicaplain #boston #hailstorm├½Ôûê_ https://t.co/MJ8rEZOXlJ",24,"['is', 'am', 'scared', 'leave']",4,21,20,3,hailstorm,0
The Stephen Ave flower pots got a little ripped up in the hailstorm today #yyc #abstorm #calgary #iamdowntown http://t.co/hBhx0dwkPC,25,"['got', 'ripped']",2,13,12,12,hailstorm,0
Hundreds of commuters abandoned at LRT station during severe hailstorm http://t.co/25wIeHMLZ5,13,['abandoned'],1,10,9,3,hailstorm,1
Hailstorm cleanup begins in Calgary http://t.co/DhH5jz2w49,8,['begins'],1,1,0,7,hailstorm,0
600 passengers abandoned at LRT station during Tuesday's hailstorm http://t.co/eLZoyEqA3m #yyc #yycstorm #abstorm,19,['abandoned'],1,10,9,9,hailstorm,1
Grow Calgary avoids worst of city's wicked weather * ~ 16 http://t.co/HLyHDfWsQB http://t.co/GwSNBMmcqF,18,['~'],1,1,0,17,hailstorm,0
Photo: This is why I am scared to leave my car under trees in a storm #jamaicaplain #boston #hailstorm... http://t.co/1FHRrhciMH,27,"['is', 'am', 'scared', 'leave']",4,23,22,4,hailstorm,0
Calgary Transit reviewing policy after leaving hundreds of commuters stranded during hail├½Ôûê_ http://t.co/fT7OrfA52y http://t.co/Dv4MMlsO1I,18,"['leaving', 'stranded']",2,1,0,17,hailstorm,0
600 passengers abandoned at LRT station during Tuesday's hailstorm http://t.co/vgF41IuPkn #yyc #yycstorm #abstorm,19,['abandoned'],1,10,9,9,hailstorm,1
@leedsrouge Love what you picked! We're playing WORTH IT by FIFTH HARM/KID INK because of you! Listen &amp; Vote: http://t.co/0wrATkA2jL,29,"['picked', ""'re"", 'playing']",3,1,0,28,harm,0
IMAGINE A DOCTOR TREATING AN #EBOLA PATIENT WITHOUT EVER PLACING HIMSELF IN HARM'S WAY. http://t.co/dliZfkk30Y,20,['harm'],1,1,0,19,harm,0
You can never escape me. Bullets don't harm me. Nothing harms me. But I know pain. I know pain. Sometimes I share it. With someone like you.,35,"['escape', 'do', 'harm', 'know', 'know']",5,14,13,21,harm,0
@Norcinu @TheBodyShopAust @thomaldo tiny plastic beads used in cosmetics (scrubs toothpaste) doing great harm to aquatic ecosystems.,23,"['used', 'doing']",2,19,18,4,harm,0
@malistkiss Sunnis continue to believe they are more righteous and they continually harm Shias. Defeats the ideals of Islam.,22,"['continue', 'believe', 'are', 'harm', 'Defeats']",5,14,13,8,harm,0
Politicians are using false allegations to attack #PlannedParenthood &amp; harm women. We aren't fooled we #StandwithPP http://t.co/bIE5pfR2Ac,25,"['are', 'using', 'attack', 'are', 'fooled']",5,13,12,12,harm,0
Choking Hazard Prompts Recall Of Kraft Cheese Singles http://t.co/nJLqRqcnL9,11,['Choking'],1,1,0,10,hazard,0
@mishavelgos @MattBacal8 @ComplexMag this is so accurate I can't even speak haha... Comparing hazard to harden is so true,24,"['@', 'is', 'speak', 'Comparing', 'harden', 'is']",6,19,18,5,hazard,0
"NVIDIA recalls some Shield Tablets because of possible fire hazard

http://t.co/M3nSIx073I

#nvidia",15,['recalls'],1,10,9,5,hazard,0
Road closures remain in effect due to hazard trees falling tree torching and uphill runs of the fire. Forest Service Road #1 remains close,26,"['closures', 'remain', 'hazard', 'falling']",4,8,7,18,hazard,1
OEM 2001 Volvo XC70 Center Dashboard Hazard Lamps Control Switch w/Vent Panel http://t.co/VXixYcbbtH http://t.co/HSDonZ49hd,18,['hazard'],1,1,0,17,hazard,0
CONFIRMED: Sanchez Hazard and Bolasie will be out for the rest of the season. https://t.co/7Ct01nEptL,19,['be'],1,1,0,18,hazard,0
@Dead_Dreamer15 ...because if it were on fire that'd be a safety hazard,15,"['were', 'be']",2,15,14,0,hazard,0
"@fplhints hazard depay ozil Ritchie .
Should I go with 3 crazy strikers or 4 midfielders ? #fplboss",20,['go'],1,3,2,17,hazard,0
Choking Hazard Prompts Recall Of Kraft Cheese Singles http://t.co/98nOsYzu58,11,['Choking'],1,1,0,10,hazard,0
8/6/2015@1:32 PM: HAZARD IN HIGH TRAFFIC AREA at 5000 DEANS BRIDGE RD http://t.co/itZzKWfhG5,18,['hazard'],1,1,0,17,hazard,1
@LondonFire Hi ..Is there an email that people can use to report s'thing they think is a fire hazard/dangerous?,21,"['use', 'report', ""s'thing"", 'think', 'is']",5,20,19,1,hazard,0
Road Hazard @ E CONFEDERATE AVE SE / MORELAND AVE SE http://t.co/tym6tYmh4M,14,['hazard'],1,1,0,13,hazard,0
I-10 EB at MS line update: Offloading the hazardous material is going much slower than expected. Road could stay closed until tomorrow AM.,26,"['Offloading', 'is', 'going', 'expected', 'stay', 'closed']",6,10,9,16,hazardous,0
#Taiwan Grace: expect that large rocks trees mud unstable and/or saturated land may slide ..very hazardous in hilly/mountain areas...,22,"['expect', 'mud', 'saturated', 'slide']",4,18,17,4,hazardous,1
DLH issues Hazardous Weather Outlook (HWO) http://t.co/WOzuBXRi2p,11,['hazardous'],1,1,0,10,hazardous,1
JAX issues Hazardous Weather Outlook (HWO)  http://t.co/u9fCb8dz3h #WX,13,['hazardous'],1,1,0,12,hazardous,1
#alfa #forecast Olap #world pres: http://t.co/YiFXKRQx0C How To Recognize A Hazardous Waste And The Multidimen http://t.co/HO4b3L0KI8,24,"['//t.co/YiFXKRQx0C', 'Recognize']",2,1,0,23,hazardous,0
#foodscare #offers2go #NestleIndia slips into loss after #Magginoodle #ban unsafe and hazardous for #humanconsumption,20,['slips'],1,17,16,3,hazardous,0
Skinny Jeans are Hazardous for Your Health! #socialnews http://t.co/92Pk0HujD8,13,['are'],1,1,0,12,hazardous,0
From recycling to only using non-hazardous chemicals Holland 1916 continually strives to maintain an eco-friendly existence.,17,"['recycling', 'using', 'Holland', 'strives', 'maintain']",5,1,0,16,hazardous,0
#dam #gms Olap #world pres: http://t.co/mIcjNPuhG0 How To Recognize A Hazardous Waste And The Multidimensional http://t.co/Vddi5ChKTP,24,"['//t.co/mIcjNPuhG0', 'Recognize']",2,1,0,23,hazardous,0
JKL issues Hazardous Weather Outlook (HWO)  http://t.co/4e719w6m4V #WX,13,['hazardous'],1,1,0,12,hazardous,1
@moneymaker32931 tanker truck overturned carrying hazardous materials.,9,"['overturned', 'carrying']",2,7,6,2,hazardous,0
CHS issues Hazardous Weather Outlook (HWO)  http://t.co/lbkiyfwFlU #WX,13,['hazardous'],1,1,0,12,hazardous,1
MEG issues Hazardous Weather Outlook (HWO)  http://t.co/gGn39m60tL #WX,13,['hazardous'],1,1,0,12,hazardous,1
TSA issues Hazardous Weather Outlook (HWO) http://t.co/7vlu8ni90Q,11,['hazardous'],1,1,0,10,hazardous,1
Caution: breathing may be hazardous to your health.,10,['be'],1,6,5,4,hazardous,0
@TheBlackshag @dannyoneil too toxic...cancer....disease...hazardous waste...noxious...,16,['dannyoneil'],1,12,11,4,hazardous,0
MEG issues Hazardous Weather Outlook (HWO) http://t.co/3X6RBQJHn3,11,['hazardous'],1,1,0,10,hazardous,1
It's getting to be hazardous getting into this world alive. https://t.co/BJZSSw4tid,15,"[""'s"", 'getting', 'be', 'getting']",4,6,5,9,hazardous,1
#triangle #peter Olap #world pres: http://t.co/JeHTQAqDFh How To Recognize A Hazardous Waste And The Multidime http://t.co/gwXdjd8nGu,24,"['//t.co/JeHTQAqDFh', 'Recognize']",2,1,0,23,hazardous,0
#foodscare #offers2go #NestleIndia slips into loss after #Magginoodle #ban unsafe and hazardous for #humanconsumption,20,['slips'],1,17,16,3,hazardous,0
http://t.co/rOdpt33XFM EverSafe Emergency Auto Kit for all Weather Unsafe hazardous rush-hour gridlock jumper-ca├½Ôûê_ http://t.co/0BVK5tuB4J,18,['hazardous'],1,12,11,6,hazardous,0
SH 29 Kaimai Ranges - Eastbound. Hazardous driving conditions. Due To A Truck Breakdown... http://t.co/0cuCMZCmaO via @AA_Traffic,23,['driving'],1,1,0,22,hazardous,0
MTR issues Hazardous Weather Outlook (HWO) http://t.co/tGLK2UUs2Z,11,['hazardous'],1,1,0,10,hazardous,0
HAZARD - HAZARDOUS CONDITION at SB I5 FWY AT / SW TERWILLIGER BLVD PORTLAND OR [Portland Police #PP15000266858] 17:26 #pdx911,24,['hazardous'],1,1,0,23,hazardous,1
Skinny Jeans are Hazardous for Your Health! #socialnews http://t.co/pAQanenCeS,13,['are'],1,1,0,12,hazardous,0
#psd #special Olap #world pres: http://t.co/9xO9mKQqsi How To Recognize A Hazardous Waste And The Multidimensi http://t.co/BP03eAFEWR,24,"['//t.co/9xO9mKQqsi', 'Recognize']",2,1,0,23,hazardous,0
DLH issues Hazardous Weather Outlook (HWO)  http://t.co/a0Ad8z5Vsr #WX,13,['hazardous'],1,1,0,12,hazardous,0
Skinny Jeans are Hazardous for Your Health! #socialnews http://t.co/LTMa9xQXpx,13,['are'],1,1,0,12,hazardous,0
"I added some dumb ideas to beat the #summer heat cheaply
 http://t.co/jatxpAFvA9 @brokelyn #brokelynati",19,"['added', 'beat']",2,1,0,18,heat wave,0
RT @startelegram: Homeless vulnerable during North Texas heat wave http://t.co/k9aIrFQ3QL http://t.co/JdBTlyMEhY,17,['heat wave'],1,1,0,16,heat wave,1
Heat Advisory is In Effect From 1 PM Through 7 PM Thursday. A Building Heat Wave and Increasing Humidity... #lawx http://t.co/u0SYkowVWV,26,['is'],1,1,0,25,heat wave,1
New Post: Diff Durden  - Heat Wave - CA - http://t.co/jGjgR4o5K0 Vote On Blog #DHHJ #HipHop #Chicago #NP http://t.co/1W10uKVHoo,28,['heat wave'],1,1,0,27,heat wave,1
Apocalpytic Iran Heat Wave Nearly Breaks World Record http://t.co/Y8WLOcTeVC,11,['heat wave'],1,1,0,10,heat wave,0
Japan Heat Wave Intensifies ├½Ôûê├è Death Toll Surges To 55  http://t.co/irpSSresRq,13,['heat wave'],1,1,0,12,heat wave,1
Yeah it actually is this whole week we in a heat wave :( https://t.co/cB2NWtGy47,17,"['Yeah', 'is']",2,1,0,16,heat wave,1
"@WaseemBadami Condemning of Deaths More than 1000 due to Heat Wave in Karachi. 
May Allah gv Patience to their Heirs. http://t.co/iTG84q7vIi",26,['heat wave'],1,1,0,25,heat wave,1
Something Frightening is Happening to the Weather in the Middle East http://t.co/bDOTQ8dSlN,14,"['Something', 'is', 'Happening']",3,1,0,13,heat wave,0
@creationsbykole cork city in Ireland...we got to 17 degrees today...that is a heat wave for us haha,22,"['got', 'is', 'haha']",3,1,0,21,heat wave,0
@hollywarnexx mini heat wave apaz,6,['wave'],1,1,0,5,heat wave,0
It's nice out. Guessing the heat wave is over.,12,"[""'s"", 'Guessing', 'is']",3,1,0,11,heat wave,0
"UAE cool to Mideast heat-wave; rain watch latest [video]
NCMS issues warning of thundering rain poor visibility.... http://t.co/Tk65sKe0zm",25,"['rain', 'warning', 'thundering']",3,1,0,24,heat wave,0
Activists Protest Pipelines in Canada and Shell in Portland Oh and Prepare for Another Heat Wave http://t.co/aKsYPKjdpB #CampLogistics,21,['heat wave'],1,1,0,20,heat wave,0
@KlaraJoelsson Well I have seen it now! That's a bummer. We've had this heat wave tho... 43'c!! I'd prefer the rain... :P,35,"['have', 'seen', ""'s"", ""'ve"", 'had', 'wave', 'prefer']",7,1,0,34,heat wave,0
It's a heat wave. #Squad #RevItUp #PizzaRev http://t.co/bp8bm8xSXw,15,"[""'s""]",1,1,0,14,heat wave,0
#Jackson #ms Longest Streak of Triple-Digit Heat Since 2013 Forecast in Dallas http://t.co/Ih0Awv3L1O,17,['heat wave'],1,1,0,16,heat wave,0
Must Read Forecast! Longest Streak of Triple-Digit Heat Since 2013 What happens next? http://t.co/xXOuPfy8nQ http://t.co/A3BJabHQhe,21,['happens'],1,1,0,20,heat wave,0
@wfaaweather Pete when will the heat wave pass? Is it really going to be mid month? Frisco Boy Scouts have a canoe trip in Okla.,29,"['Is', 'going', 'be', 'have']",4,1,0,28,heat wave,0
NOT.. Ready for this heat wave .. I don't want the sun to come back out.. I'm enjoying this break of cooler temps..,25,"['wave', '..', 'do', 'want', 'come', ""'m"", 'enjoying']",7,1,0,24,heat wave,0
It's kinda cool tonight. Is the heat wave finally over?? ???? 7amdollela 3la kulli 7aal,22,"[""'s"", 'Is', 'wave']",3,1,0,21,heat wave,0
Heat Wave: A Social Autopsy of Disaster in Chicago by Klinenberg Eric http://t.co/fPtqxVokJC http://t.co/0gt63uQGcU,19,['heat wave'],1,1,0,18,heat wave,0
@sportguyshow the heat wave ends really tomorrow but still time for another one to build. Only other thing that ends the heat is Autumn.,27,"['sportguyshow', 'wave', 'build', 'ends', 'is']",5,1,0,26,heat wave,0
Heat wave is ending! Watching a big area of rain though...will impact part of the area. Details NOW on NBC10 at 5pm,26,"['is', 'ending', 'Watching', 'impact']",4,1,0,25,heat wave,0
@rachelcaine The weatherit needs to make it minds up. First snow tornadoes now would you say a heat wave?,22,"['rachelcaine', 'needs', 'make', 'minds', 'say']",5,1,0,21,heat wave,0
Japan heat wave intensifies - death toll surges to 55: http://t.co/F1h1mzVSNn via @extinctionp,17,['surges'],1,1,0,16,heat wave,1
Middle East ├½Ôûê┬ñHeat Dome├½Ôûê├ÿ Causes Crippling Heat Wave in Israel http://t.co/41Lcb9aepR,13,['heat wave'],1,1,0,12,heat wave,0
Heat wave in WB heavy losses and no compensations (report) -  http://t.co/wMDihdiz1r (via PalinfoEn)   #Palestine,22,['wave'],1,1,0,21,heat wave,0
Heat wave adding to the misery of internally-displaced Gazans http://t.co/jW3hN9ewFT via @PressTV http://t.co/NYWrkRQ7Kn,18,"['wave', 'adding']",2,1,0,17,displaced,1
Heat wave gotta be over 9000 today,8,"['wave', 'got', 'be']",3,1,0,7,heat wave,1
@facilitydude shares how to handle the heat and keep your cool http://t.co/ekEd6BulsZ  #facilitiesmanagement,17,"['handle', 'keep']",2,1,0,16,heat wave,0
Longest Streak of Triple-Digit Heat Since 2013 Forecast in Dallas http://t.co/xc96rWUSZb http://t.co/XM9stfzcpV,16,['heat wave'],1,1,0,15,heat wave,0
God the past few nights have been awesome but tonight it looks like the heat wave is back ?? can't breathe in my room!,27,"['have', 'been', 'tonight', 'looks', 'is', 'breathe']",6,1,0,26,heat wave,0
http://t.co/OYMLNLHEca So important to stay hydrated in the midst of this heat wave├½Ôûê_ ?? ├½Ôûê_ http://t.co/EXLQxSa0i8 http://t.co/M3TiNl4NUX,24,"['stay', 'hydrated']",2,1,0,23,heat wave,0
Good morning. Slept about 6 hours. The heat wave hits Japan... The hot days still continue. I guess some people were killed by this climate.,30,"['Slept', 'wave', 'continue', 'guess', 'were', 'killed']",6,1,0,29,heat wave,0
Japan heat wave intensifies ├½Ôûê├è death toll surges to 55 http://t.co/ZwPoDn3KOH,13,"['├½Ôûê├è', 'surges']",2,1,0,12,heat wave,1
weather warfare Follow the Money This Government Is What Our Founding Fathers Were Warning Us About The Weather... http://t.co/TgtCRU8jiO,22,"['Is', 'Founding', 'Warning']",3,1,0,21,heat wave,0
The Prophet (peace be upon him) said 'Save yourself from Hellfire even if it is by giving half a date in charity.',26,"['be', 'said', 'is', 'giving']",4,1,0,25,hellfire,0
Hellfire is surrounded by desires so be careful and don├½Ôûê┬¼t let your desires control you! #Afterlife,18,"['is', 'surrounded', 'be', 'let', 'control']",5,1,0,17,hellfire,0
Hellfire is surrounded by desires so be careful and don├½Ôûê┬¼t let your desires control you! #Afterlife,18,"['is', 'surrounded', 'be', 'let', 'control']",5,1,0,17,hellfire,0
#Allah describes piling up #wealth thinking it would last #forever as the description of the people of #Hellfire in Surah Humaza. #Reflect,28,"['describes', 'piling', 'thinking']",3,1,0,27,hellfire,0
Come watch @QelricDK bash some face in Hellfire Citadel! http://t.co/juQIuN2mhg,14,['bash'],1,1,0,13,hellfire,0
Fel Lord Zakuun is about to DIE ! #Hellfire #WOD http://t.co/x1oNV3d5uX,15,['is'],1,1,0,14,hellfire,0
The Prophet (peace be upon him) said 'Save yourself from Hellfire even if it is by giving half a date in charity.',26,"['be', 'said', 'is', 'giving']",4,1,0,25,hellfire,0
Hellfire! We don├½Ôûê┬¼t even want to think about it or mention it so let├½Ôûê┬¼s not do anything that leads to it #islam!,25,"['don├½Ôûê┬¼t', 'want', 'think', 'mention', 'let├½Ôûê┬¼s', 'do', 'leads']",7,1,0,24,hellfire,0
Tension In Bayelsa As Patience Jonathan Plans To Hijack APC PDP - http://t.co/ComLG0VdbV,15,['Plans'],1,1,0,14,hijack,1
Bayelsa poll: Tension in Bayelsa as Patience Jonathan plans to hijack APC PDP: Plans by former First Lady and... http://t.co/86RSYy2tng,25,"['plans', 'hijack']",2,12,11,13,hijack,1
Himika Amase is the only prophet in the world who foresaw 'hijack in March' as it was on her Jps Twitter in Feb 2014. malyasiaairlines. ???,30,"['is', 'foresaw', 'was']",3,1,0,29,hijack,0
@dreamoforgonon @TeeEss not to hijack but as a bona fide cislady I can confirm this as true; incidental homosexuality =/= gay/bi for women.,27,"['hijack', 'confirm']",2,7,6,20,hijack,0
RT! Tension In Bayelsa As Patience Jonathan Plans To Hijack APC PDP http://t.co/JlE6aFuG3p,16,['Plans'],1,1,0,15,hijack,1
Tension In Bayelsa As Patience Jonathan Plans To Hijack APC PDP - The Sun: Plans by former├½Ôûê_ http://t.co/qJPrrObGtC http://t.co/XWoGt4wBf7,24,['Plans'],1,1,0,23,hijack,1
I've just posted on my Blog about: Criminals Who Hijack Lorries And Buses Arrested In Enugu (PHOTO) http://t.co/5ytIeX55lh,24,"[""'ve"", 'posted', 'Hijack', 'Arrested']",4,1,0,23,hijack,0
Biggest security update in history coming up: Google patches Android hijack bug Stagefright http://t.co/LTid39bKBE,17,['coming'],1,12,11,5,hijack,0
Criminals Who Hijack Lorries And Buses Arrested In Enugu (PHOTO) http://t.co/LRTU8Rwn2f,15,"['Hijack', 'Arrested']",2,1,0,14,hijack,0
Tension In Bayelsa As Patience Jonathan Plans To Hijack APC PDP http://t.co/epABiNcZmJ http://t.co/1SgzGtgfw9,17,['Plans'],1,1,0,16,hijack,1
Plans by former First Lady and wife of ex-President Goodluck Jonathan Dame Patience Jonathan to hijack the All... http://t.co/HaShGQAFic,22,['hijack'],1,16,15,6,hijack,0
Patience Jonathan On The Move To Hijack APC In Bayelsa State http://t.co/rJac5sItEp http://t.co/Plqf1bikS4,17,['hijack'],1,1,0,16,hijack,0
Tension In Bayelsa As Patience Jonathan Plans To Hijack APC PDP - The Sun http://t.co/VBiGAnIRSJ,17,['Plans'],1,1,0,16,hijack,1
Criminals Who Hijack Lorries And Buses Arrested In Enugu: According to the Nigerian Police Force... http://t.co/FfKcj8pfj2 Via @Music212,23,"['Hijack', 'Arrested', 'According']",3,1,0,22,hijack,0
Chrysler Jeep wirelessly hacked over internet to hijack steering brakes and transmission face lawsuit - should all consider #ISO27001,20,"['hacked', 'hijack', 'steering', 'consider']",4,8,7,12,hijack,0
{:en}Tension In Bayelsa As Patience Jonathan Plans To Hijack APC├òÔò®PDP{:} http://t.co/W1ufeibALa http://t.co/bIULQpRxke,23,['Plans'],1,1,0,22,hijack,1
Swansea ├½Ôûê┬©plot hijack transfer move for Southampton target Virgil van Dijk├½Ôûê┬¼ http://t.co/PVmr38LnvA,14,['hijack'],1,3,2,11,hijack,0
hijack,1,['hijack'],1,1,0,0,hijack,0
#LatestNews: Tension In Bayelsa As Patience Jonathan Plans To Hijack APC PDP,14,['Plans'],1,1,0,13,hijack,1
Tension In Bayelsa As Patience Jonathan Plans To Hijack APC PDP http://t.co/qxXN6RKsp6 http://t.co/B3X1wqzAoR,17,['Plans'],1,1,0,16,hijack,1
Swansea ?plot hijack transfer move for Southampton target Virgil van Dijk? http://t.co/PYL26NFEn8,16,['hijack'],1,4,3,12,hijack,0
Tension In Bayelsa As Patience Jonathan Plans To Hijack APC PDP - http://t.co/NIpZmfLiBD,15,['Plans'],1,1,0,14,hijack,1
Criminals Who Hijack Lorries And Buses Arrested In Enugu (PHOTO) http://t.co/5cZ7eM9OTr,15,"['Hijack', 'Arrested']",2,1,0,14,hijack,0
Swansea ├½Ôûê┬©plot hijack transfer move for Southampton target Virgil van Dijk├½Ôûê┬¼ http://t.co/PVmr38LnvA,14,['hijack'],1,3,2,11,hijack,0
Governor Allows Parole for School Bus Hijacker http://t.co/JwfiiLJ8Wr liveleakfun ? http://t.co/IONWArVRFy,15,['hijacker'],1,1,0,14,hijacker,0
Governor allows parole for California school bus hijacker who kidnapped 26 children in 1976. http://t.co/hdAhLgrprl http://t.co/Z1s3T77P3L,20,"['allows', 'kidnapped']",2,8,7,12,hijacker,0
Remove the http://t.co/VbqmZ5aPwj and Linkury Browser Hijacker http://t.co/C2EyjNyBfN http://t.co/gt7gf0fSeX,15,['Remove'],1,1,0,14,hijacker,0
Governor allows parole for California school bus hijacker http://t.co/0aQBZmrvLQ via @abc7newsbayarea,14,['allows'],1,8,7,6,hijacker,0
The Hijacker-Turned-SAT-Tutor Who Evaded Authorities for Three Decades http://t.co/cSXvwXUZ6t via @slate,14,['hijacker'],1,1,0,13,hijacker,0
Governor Allows Parole for School Bus Hijacker http://t.co/DzlPNP399x,10,['hijacker'],1,1,0,9,hijacker,0
Governor Allows Parole for School Bus Hijacker http://t.co/liKWQhSHHX via @nbcnews I remember this crime sent chills through parents,21,"['remember', 'sent']",2,1,0,20,hijacker,0
School Bus Hijacker Given Parole After 39 Years http://t.co/HmRt98OydJ,11,['hijacker'],1,1,0,10,hijacker,0
Remove the http://t.co/JAb541hHk0 and Linkury Browser Hijacker http://t.co/Je6Zjwh5uB http://t.co/fDxgmiwAEh,15,['Remove'],1,1,0,14,hijacker,0
Governor Allows Parole for School Bus Hijacker http://t.co/u4bdy1W7d4,10,['hijacker'],1,1,0,9,hijacker,0
Medieval airplane hijacker testa: earnings the distinction divers: HtaRvrGLY,11,['hijacker'],1,3,2,8,hijacker,0
@JagexSupport can u remove the email of the hijacker pls !! YKJL is my ign. i need to recover but pls block so they dont break bank pin!,32,"['u', 'remove', 'is', 'i', 'need', 'recover', 'pls', 'dont']",8,10,9,22,hijacker,0
California School Bus Hijacker Parole Stands http://t.co/kPIVXGjNqt #sacramento,11,['hijacker'],1,1,0,10,hijacker,0
Governor Allows Parole for School Bus Hijacker http://t.co/7mqh7fhxYL http://t.co/BNCcwcsCKt #SahelNews,15,['hijacker'],1,1,0,14,hijacker,0
Governor allows parole for California school bus hijacker: Local... http://t.co/tAM6aoskoJ http://t.co/eL24mnFcHw,17,['allows'],1,8,7,9,hijacker,0
├½Ôûê┬©Hijacker cops├½Ôûê┬¼ back in the dock - http://t.co/9I5cczD5S0 http://t.co/WEaTrRihE1,13,['hijacker'],1,1,0,12,hijacker,1
Governor Allows Parole for School Bus Hijacker http://t.co/N71hMveRvv,10,['hijacker'],1,1,0,9,hijacker,0
Governor weighs parole for California school bus hijacker http://t.co/yFPpIFDkQO http://t.co/aJYUlMFTIF,14,['weighs'],1,8,7,6,hijacker,0
"Updated on Friday at 4:30 A.M. - Daily Area News
California School Bus Hijacker Parole Stands http://t.co/24QEkAh893",19,['Updated'],1,1,0,18,hijacker,0
Governor allows parole for California school bus hijacker http://t.co/FZ8YtWQkwV #fresno,13,['allows'],1,8,7,5,hijacker,0
RT NotExplained: The only known image of infamous hijacker D.B. Cooper. http://t.co/JlzK2HdeTG,17,['NotExplained'],1,10,9,7,hijacker,0
Governor Allows Parole for School Bus Hijacker http://t.co/i7PIJK6XtM liveleakfun ? http://t.co/IONWArVRFy,15,['hijacker'],1,1,0,14,hijacker,0
Medieval airplane hijacker hard shell: casting the star deviating: dYxTmrYDu,12,['casting'],1,3,2,9,hijacker,0
Governor allows parole for California school bus hijacker - Santa Cruz Sentinel http://t.co/TaXUxp9QA2,15,['allows'],1,8,7,7,hijacker,0
Earnest Pletch├½Ôûê┬¼s cold-blooded killing of Carl Bivens was just one chapter in his strange life http://t.co/dnQn1OWWF9 http://t.co/xNEPq5HBYD,21,['was'],1,1,0,20,hijacking,0
#hot  Funtenna: hijacking computers to send data as sound waves [Black Hat 2015] http://t.co/EZ1TpCzJzo #prebreak #best,24,"['hijacking', 'send', 'waves']",3,5,4,19,hijacking,0
The Murderous Story Of America├½Ôûê┬¼s First Hijacking http://t.co/VgBOpxb6Wg,10,['hijacking'],1,1,0,9,hijacking,0
The Murderous Story Of America├½Ôûê┬¼s First Hijacking http://t.co/cbPs1gskvO,10,['hijacking'],1,1,0,9,hijacking,0
#hot  Funtenna: hijacking computers to send data as sound waves [Black Hat 2015] http://t.co/J2aQs5loxu #prebreak #best,24,"['hijacking', 'send', 'waves']",3,5,4,19,hijacking,0
The Murderous Story Of America├½Ôûê┬¼s First Hijacking: Earnest Pletch├½Ôûê┬¼s cold-blooded killing of├½Ôûê_ http://t.co/B9JAxx0vCf,16,['killing'],1,1,0,15,hijacking,0
The Murderous Story Of America├½Ôûê┬¼s First Hijacking http://t.co/QAOqtptgwH,10,['hijacking'],1,1,0,9,hijacking,0
The Murderous Story Of America├½Ôûê┬¼s First Hijacking http://t.co/EYUGk6byxr,10,['hijacking'],1,1,0,9,hijacking,0
├½Ôûê┬©Good Samaritans├½Ôûê┬¼ shot in horror hijacking  JOHANNESBURG. &amp;mdash; Four men were shot dead in Bronville Free State├½Ôûê_ http://t.co/6jjvCDN4TI,25,"['were', 'shot']",2,6,5,19,hijacking,0
#hot  Funtenna: hijacking computers to send data as sound waves [Black Hat 2015] http://t.co/qj3PVgaVN7 #prebreak #best,24,"['hijacking', 'send', 'waves']",3,5,4,19,hijacking,0
MomentsAtHill everyone hijacking NuNus and timas bikes ????,11,"['hijacking', 'timas']",2,3,2,8,hijacking,0
But is feast.dll still vulnerable to DLL hijacking?  https://t.co/3vaig1PtYk https://t.co/BZDNKpOry1,15,"['is', 'DLL', 'hijacking']",3,8,7,7,hijacking,0
@USAgov Koreans are performing hijacking of the Tokyo Olympic Games.https://t.co/APkSnpLXZj,13,"['are', 'performing']",2,6,5,7,hijacking,0
Vehicle Hijacking in  Vosloorus Gauteng on 2015-08-05 at 23:00 White Toyota Conquest  BKB066GP http://t.co/odmP01eyZU,16,['hijacking'],1,1,0,15,hijacking,0
@ReasonVsFear 'One?'  Oh nonononono.  This hijacking's been going on forever but I've seen it about a dozen diff places today alone.,28,"['been', 'going', ""'ve"", 'seen']",4,10,9,18,hijacking,0
@Drsarwatzaib070 come on. IK will face MCourt for attacking parliment and hijacking TV station.,17,"['face', 'attacking', 'hijacking']",3,14,13,3,hijacking,0
#hot  Funtenna: hijacking computers to send data as sound waves [Black Hat 2015] http://t.co/cOMuiOk3mP #prebreak #best,24,"['hijacking', 'send', 'waves']",3,5,4,19,hijacking,0
#hot  Funtenna: hijacking computers to send data as sound waves [Black Hat 2015] http://t.co/xV3D9bPjHi #prebreak #best,24,"['hijacking', 'send', 'waves']",3,5,4,19,hijacking,0
The Murderous Story Of America├½Ôûê┬¼s First Hijacking http://t.co/jmAwRLt7HB,10,['hijacking'],1,1,0,9,hijacking,0
├½Ôûê┬©Good Samaritans├½Ôûê┬¼ shot in horror hijacking http://t.co/V5yUUALoqw #263Chat #Twimbos ZimpapersViews,14,['hijacking'],1,6,5,8,hijacking,0
The Murderous Story Of America├½Ôûê┬¼s First Hijacking http://t.co/LK5uqKOP1e,10,['hijacking'],1,1,0,9,hijacking,0
#hot  Funtenna: hijacking computers to send data as sound waves [Black Hat 2015] http://t.co/UMgD92wLjA #prebreak #best,24,"['hijacking', 'send', 'waves']",3,5,4,19,hijacking,0
Who is Tomislav Salopek the Islamic State's Most Recent Hostage? http://t.co/puT3LgsDnf,15,['is'],1,1,0,14,hostage,0
Islamic State threatens to kill another hostage: @DailyGleaner @TJProvincial @TJGreaterSJ http://t.co/dfPLiqjMk2,17,"['threatens', 'kill']",2,7,6,10,hostage,1
Ya kisses hold me hostage &amp; I don't wanna stop it. I only wanna give it to you,24,"['hold', 'do', 'wan', 'stop', 'wan', 'give']",6,5,4,19,hostage,0
Pakistani Terrorist Was Captured By Villagers He Took Hostage - NDTV http://t.co/C5X10JAkGE,14,['Captured'],1,1,0,13,hostage,0
"Oh god Diane is following them to the hostage exchange in a taxi. 
#RandomActsOfRomance",16,"['is', 'following']",2,9,8,7,hostage,0
Sinai branch of Islamic State threatens to execute Croatian hostage in 48 hours http://t.co/YvtcXrPt34,16,"['threatens', 'execute']",2,10,9,6,hostage,0
Egyptian Militants Tied to ISIS Threaten to Kill Croatian Hostage (New York Times) http://t.co/GTXndnJRrl (1717 GMT),22,['hostage'],1,1,0,21,hostage,1
Concealed Carrier Rescues Hostage Captures Naked Attacker http://t.co/uLy5hM6PqR,10,['Concealed'],1,1,0,9,hostage,0
Islamic State group threatens to kill hostage if ├½Ôûê┬©Muslim women├½Ôûê┬¼ aren├½Ôûê┬¼t let go - http://t.co/48Zg5ynebn...,18,"['threatens', 'kill', 'hostage', 'go']",4,7,6,11,hostage,1
UPDATE 4-IS Egypt affiliate threatens to kill Croatian hostage in 48├òÔò®hours http://t.co/C0zrqIk6KE,14,['kill'],1,9,8,5,hostage,1
quoted here--&gt;CNN: Purported ISIS video threatens Croatian hostage http://t.co/swVuZxi6gT,17,"['quoted', 'Purported', 'threatens']",3,14,13,3,hostage,1
Islamic State group in Egypt threatens to kill Croat hostage http://t.co/NzIfztCUGL,13,"['threatens', 'kill']",2,10,9,3,hostage,1
'IS Egypt affiliate threatens to kill Croatian hostage in 48 hours' - http://t.co/3LcgidRQpb,16,['kill'],1,8,7,8,hostage,1
Islamic State group threatens to kill hostage if 'Muslim women' aren't let go - Press Herald http://t.co/yKM6qfRh98,21,"['threatens', 'kill', 'hostage', 'are', 'let', 'go']",6,7,6,14,hostage,1
Related News: 'ISIS video' threatens hostage - Europe - CNN |  http://t.co/Wk6B5z803o,16,"['Related', 'hostage']",2,8,7,8,hostage,1
@EvaHanderek @MarleyKnysh great times until the bus driver held us hostage in the mall parking lot lmfao,19,['held'],1,13,12,6,hostage,0
The horrific story of being a hostage - The horrific story of being a hostage It's 1974 and on a British... http://t.co/XcQ48OuRvL,26,"['being', 'being', ""'s""]",3,15,14,11,hostage,0
Bit-Defender hack ├½Ôûê├è Held Hostage!: Late last week it was discovered that antivirus vendor ... http://t.co/2vC8CSTWy5 #damballa #infosec,24,"['was', 'discovered']",2,1,0,23,hostage,0
Islamic State group in Egypt threatens to kill Croat hostage http://t.co/VdgfXYX3bw,13,"['threatens', 'kill']",2,10,9,3,hostage,0
Murfreesboro peeps- I'm hearing Walmart on S Rutherford is on lockdown with a hostage is that true or a rumor?,22,"[""'m"", 'hearing', 'is', 'is']",4,15,14,7,hostage,0
#BREAKING. Who is Tomislav Salopek the Islamic State's Most Recent Hostage?  /#news,18,['is'],1,1,0,17,hostage,0
Islamic State group in Egypt threatens to kill Croat hostage http://t.co/eIoQJWgEiX,13,"['threatens', 'kill']",2,10,9,3,hostage,0
@mylittlepwnies3 @Early__May @AnathemaZhiv @TonySandos much of which has to do with lebanon 80s attack/ iran hostage crisis/ Libya Pan am,24,"['has', 'do', 'am']",3,20,19,4,hostage,0
I went to pick up my lunch today and the bartender was holding my change hostage because he wanted my number. ??,24,"['went', 'pick', 'was', 'holding', 'wanted']",5,16,15,8,hostage,0
@pmarca content is held hostage by network due to affiliation fees.,13,"['is', 'held']",2,6,5,7,hostage,0
New ISIS Video: ISIS Threatens to Behead Croatian Hostage Within 48 Hours - TLVFaces - TLVFaces#auspol http://t.co/a6PPEgeLOX,22,"['Threatens', 'Behead', 'TLVFaces']",3,1,0,21,hostage,1
Sydney hostage crisis has now been recovered from the AirAsia wreckage.,12,"['has', 'been', 'recovered']",3,2,1,10,hostage,0
video says #ISIS Threatens To Kill Croatian Hostage 5oil-worker) If #Egypt Does Not Release Female Prisoners in 48 H http://t.co/GvpKrRdQnu,25,['says'],1,1,0,24,hostage,1
2 hostages in Libya remain unharmed: Government sources on Wednesday denied reports that two Indian nationals who├½Ôûê_ http://t.co/EX4FnJjL6H,21,"['remain', 'denied', 'who├½Ôûê_']",3,2,1,19,hostages,0
#hot  C-130 specially modified to land in a stadium and rescue hostages in Iran in 1980 http://t.co/wpGvAyfkBQ #prebreak #best,24,"['modified', 'land']",2,13,12,11,hostages,0
#hot  C-130 specially modified to land in a stadium and rescue hostages in Iran in 1980 http://t.co/6ioaBSl6I7 #prebreak #best,24,"['modified', 'land']",2,13,12,11,hostages,0
@hannahkauthor Read: American lives first | The Chronicle #FreeAmirNow #FreeALLFour #Hostages held by #Iran #IranDeal http://t.co/gWnLHNeKu9,25,"['|', 'held']",2,1,0,24,hostages,0
C-130 specially modified to land in a stadium and rescue hostages in Iran in 1980 http://t.co/jkD7CTi2iW http://t.co/LAjN2n5e2d,21,"['modified', 'land']",2,11,10,10,hostages,0
"Russia stood down cold war nuke ban or face ocean superiority 
Unconditional surrender next putin
Game set match
Release the hostages",21,"['stood', 'ocean', 'set']",3,21,20,0,hostages,0
Sinjar Massacre Yazidis Blast Lack of Action Over├òÔò®Hostages http://t.co/Carvv6gsRb http://t.co/lAn76ZqKxG,14,['hostages'],1,1,0,13,hostages,0
#hot  C-130 specially modified to land in a stadium and rescue hostages in Iran in 1980 http://t.co/zLco4UE5OQ #prebreak #best,24,"['modified', 'land']",2,13,12,11,hostages,0
#hot  C-130 specially modified to land in a stadium and rescue hostages in Iran in 1980 http://t.co/W0EXzAD5Gc #prebreak #best,24,"['modified', 'land']",2,13,12,11,hostages,0
C-130 specially modified to land in a stadium and rescue hostages in Iran in 1980... http://t.co/tNI92fea3u http://t.co/czBaMzq3gL,22,"['modified', 'land']",2,11,10,11,hostages,0
Militant 'Overpowered' By Hostages After Attack http://t.co/xWnp8a1JOn,10,"[""'Overpowered""]",1,1,0,9,hostages,0
#hot  C-130 specially modified to land in a stadium and rescue hostages in Iran in 1980 http://t.co/g601NBD7wS #prebreak #best,24,"['modified', 'land']",2,13,12,11,hostages,0
How until put out manorial shaped gnocchi near thine hostages to fortune: RBpK,14,"['put', 'fortune']",2,10,9,4,hostages,0
Sinjar Massacre Yazidis Blast Lack of Action Over Hostages http://t.co/q4Q8XsYZOB,12,['hostages'],1,1,0,11,hostages,0
#hot  C-130 specially modified to land in a stadium and rescue hostages in Iran in 1980 http://t.co/PtAI4zBpbI #prebreak #best,24,"['modified', 'land']",2,13,12,11,hostages,0
C-130 specially modified to land in a stadium and rescue hostages in Iran in 1980:    submitt... http://t.co/nbugSMqLRG #aviationaddicts,23,"['modified', 'land']",2,11,10,12,hostages,0
@JoeNBC IRAN: NO SNCTIONS INCL MILTARY$150BILNO INSPCTKPS HOSTAGESTHROSW ISRAEL TO GUTRKPS NUKE SITES U.S HLPS W/NUKES GET 'ZERO!',24,['hostages'],1,1,0,23,hostages,0
Ajmal Kasab II: How hostages misled the terrorist got him caught alive http://t.co/n1up959OFM,16,"['misled', 'got', 'caught']",3,6,5,10,hostages,0
Holmgren: We referred to those 35 days as 'the hostage situation.' We were Lou's 'hostages.',21,"['referred', 'were']",2,1,0,20,hostages,0
Barak will Tell the American People that the lives of the Hostages in Iran depends on Congress Voting to give Terrorist a Nuke for hostages.,26,"['Tell', 'give']",2,25,24,1,hostages,0
@minhazmerchant Great job done by village hostages,8,['done'],1,8,7,0,hostages,0
One Year On From #IS Massacre in #Sinjar Yazidis Blast Lack of Action over 3000--5000 Yazidis who remain enslaved: http://t.co/vnSn284ovw,27,['remain'],1,1,0,26,hostages,0
#hot  C-130 specially modified to land in a stadium and rescue hostages in Iran in 1980 http://t.co/fQWTSxLkrZ #prebreak #best,24,"['modified', 'land']",2,13,12,11,hostages,0
@IndiaToday @Iamtssudhir Time for India to join global war against ISIS cant sacrifice national interest to save hostages! #NationFirst,23,"['join', 'save']",2,20,19,3,hostages,0
India: Militant 'Overpowered' By Hostages After Attack http://t.co/mkjszGbaWR,12,"[""'Overpowered""]",1,1,0,11,hostages,0
#Sinjar Massacre #Yazidis Blast Lack of Action Over Hostages http://t.co/JhOaHpbpQ4 Portland #Phoenix #Newyork #Miami #Atlanta #Casper #Iraq,27,['hostages'],1,1,0,26,hostages,0
Cruz: Iran deal ├½Ôûê┬©leaves 4 American hostages languishing in Iran├½Ôûê┬¼  http://t.co/EXsQIJF4nY - #NoIranDeal  #TedCruz2016 http://t.co/y7sIPKB1kd,22,"['├½Ôûê┬©leaves', 'languishing']",2,8,7,14,hostages,0
Nigerian Military Rescue 178 Hostages From Boko Haram - Florida Sentinel Bulletin: Florid... http://t.co/KcTiGYMahl #security #terrorism,22,['hostages'],1,1,0,21,hostages,0
"One Year on from the Sinjar Massacre #Yazidis Blast Lack of Action Over Hostages
http://t.co/BAqOcMcJqc",18,['hostages'],1,1,0,17,hostages,0
Sinjar Massacre Yazidis Blast Lack of Action Over Hostages http://t.co/fdU8aCnC2W #denver #billings #rapidcity #seattle #cheyenne #lasvegas,24,['hostages'],1,1,0,23,hostages,0
Sinjar Massacre Yazidis Blast Lack of Action Over Hostages http://t.co/fdU8aCnC2W #denver #billings #rapidcity #seattle #cheyenne #lasvegas,24,['hostages'],1,1,0,23,hostages,0
@Deosl86 That does nit change the fact extracting hostages is pointless,12,"['does', 'change', 'extracting', 'is']",4,10,9,2,hostages,0
#hot  C-130 specially modified to land in a stadium and rescue hostages in Iran in 1980 http://t.co/FLqxd3q5pY #prebreak #best,24,"['modified', 'land']",2,13,12,11,hostages,0
RT WatchmanIS216: #Sinjar Massacre #Yazidis Blast Lack of Action Over Hostages http://t.co/79iQDYZjBS; Portland #├½Ôûê_ http://t.co/0z1PvJVdpf,24,['hostages'],1,1,0,23,hostages,0
#hot  C-130 specially modified to land in a stadium and rescue hostages in Iran in 1980 http://t.co/OnvD9D4NKg #prebreak #best,24,"['modified', 'land']",2,13,12,11,hostages,0
Cont'd- #Sinjar: referring to a 40-pg document the group put together on the movt of #Yazidi hostages in the days following #IS massacre [2],30,"['referring', 'put', 'following']",3,20,19,10,hostages,0
"@Nervana_1 
As per previous behaviour JAN/AQ would deal with the kidnapped hostages not particularly pleasantly if Div 30 fought JAN/AQ.",22,"['deal', 'kidnapped']",2,13,12,9,hostages,0
@zaynmaIikist listen to hurricane,5,['hurricane'],1,5,4,0,hurricane,0
HURRICANE GUILLERMO LIVE NOAA TRACKING / LOOPING WED.AUG.5TH ~ http://t.co/RjopJKbydR ~  http://t.co/NUFDgw9YEv http://t.co/2oKSCwYoHC,19,['hurricane'],1,1,0,18,hurricane,0
AngelRiveraLib├½Ôûê_ #Snowden 'may have' broken laws? Hurricane Katrina may have caused some damage. http://t.co/jAaWuiOvdc Without Snowden h├½Ôûê_,23,"['have', 'broken', 'have', 'caused']",4,1,0,22,hurricane,0
HURRICANE GUILLERMO LIVE NOAA TRACKING / LOOPING WED.AUG.5TH ~ http://t.co/ut7R2ixRjQ ~  http://t.co/v3z96YDMvD http://t.co/kxSLfTZ2I5,19,['hurricane'],1,1,0,18,hurricane,1
@Hurricane_Dame ???????? I don't have them they out here,18,"['do', 'have']",2,1,0,17,hurricane,0
@lavapixcom Did you see #hurricane #guillermo with #MeteoEarth? http://t.co/mfckpVzfV8,16,['see'],1,7,6,9,hurricane,0
@ChubbySquirrel_ @Hurricane_Surge this here is very true &gt;:33333,13,['is'],1,1,0,12,hurricane,0
Hurricane 30STM quem lembra,4,['hurricane'],1,1,0,3,hurricane,0
hurricane?? sick!,5,['hurricane'],1,1,0,4,hurricane,0
Cape Coral city leaders take part in mock hurricane training http://t.co/gtYCQyFuam http://t.co/qwd5PvGjbO,16,['take'],1,9,8,7,hurricane,0
Be careful during hurricane season ???? https://t.co/bFtOU2nybW,12,['Be'],1,4,3,8,hurricane,0
My back is so sunburned :(,7,['is'],1,1,0,6,hurricane,0
Residents artists remember aftermath of Hurricane Katrina through artwork - WDSU New Orleans: WDSU New Orlean... http://t.co/U6pAvbZoB3,21,"['artists', 'remember']",2,1,0,20,hurricane,0
Found out a hurricane is brewing for thursday lol ??????,15,"['Found', 'is', 'brewing']",3,4,3,11,hurricane,0
@VinusTrip Did you see #hurricane #guillermo with #MeteoEarth? http://t.co/mfckpVzfV8,16,['see'],1,7,6,9,hurricane,0
Grace: here are damage levels USA style.. #Taiwan #China #world hurricane/typhoon ratings/categories defined again http://t.co/OdYdT9QPk1,21,"['are', 'defined']",2,15,14,6,hurricane,1
AngelRiveraLib├½Ôûê_ #Snowden 'may have' broken laws? Hurricane Katrina may have caused some damage. http://t.co/jAaWuiOvdc Without Snowden h├½Ôûê_,23,"['have', 'broken', 'have', 'caused']",4,1,0,22,hurricane,0
HWRF absolutely lashes Taipei with Hurricane force winds High Storm Surge and 20' of rain. Not good news at all!!! http://t.co/CNkvILe7bE,28,['lashes'],1,1,0,27,hurricane,1
"Would you blow me kisses
If I kept my distance?
Would you send a hurricane
As proof of your existence?",22,"['blow', 'kisses', 'kept', 'send']",4,16,15,6,hurricane,0
@pattonoswalt @FoxNews Wait I thought Fecal Hurricane was on SciFi? Maybe that was turdnado. I've been forgeting up a shit storm lately.,28,"['thought', 'was', 'was', ""'ve"", 'been', 'forgeting']",6,1,0,27,hurricane,0
HURRICANE GUILLERMO LIVE NOAA TRACKING / LOOPING WED.AUG.5TH ~ http://t.co/AuruGJEGIQ ~  http://t.co/L3w8miPvnT http://t.co/O85M1bJFRW,19,['hurricane'],1,1,0,18,hurricane,1
HURRICANE GUILLERMO LIVE NOAA TRACKING / LOOPING WED.AUG.5TH ~ http://t.co/QktRt2J1o8 ~  http://t.co/b0JxS5QKkh http://t.co/KP05TOwSfM,19,['hurricane'],1,1,0,18,hurricane,1
@leeranaldo expressing his rage about Hurricane Sandy #LCOutOfDoors http://t.co/IwPR2qGYsI,13,['expressing'],1,1,0,12,hurricane,0
#kick #hurricane Seriously #simple websites: http://t.co/x8W7tF6FHg Looking For A Seriously Simple Program To http://t.co/9NZ9zFM93i,22,"['Looking', 'http']",2,4,3,18,hurricane,0
@Hurricane_Dolce no prob,4,['hurricane'],1,1,0,3,hurricane,0
Happy birthday bro ?? @Hurricane_Dolce,7,['bro'],1,1,0,6,hurricane,0
Brooklyn Sites Get $2.6 Million to Undo Hurricane Sandy├½Ôûê┬¼s Toll http://t.co/HukwD0RE2a,14,['hurricane'],1,1,0,13,hurricane,0
Ashley and I on going to hurricane harbor Friday. ?? http://t.co/ScEfPFvAEU,15,"['going', 'hurricane']",2,7,6,8,hurricane,0
Udhampur terror attack: Militants attack police post 2 SPOs injured: Suspected militants tonight attacked a p... http://t.co/nZAFokxX0h,22,"['attack', 'injured', 'tonight']",3,11,10,11,injured,1
"Militants attack police post in Udhampur; 2 SPOs injured

Suspected militants Thursday  attacked a police post in... http://t.co/1o0j9FCPBi",22,"['injured', 'attacked']",2,10,9,12,injured,1
UPDATE:M.E. confirms 2 women pulled from burning house died last Friday. 91 yr old Edna Jefferson&amp;Doris Sherfield72. http://t.co/L6nSLzl7mI,29,"['confirms', 'pulled', 'burning', 'died']",4,1,0,28,injured,0
4 dead dozens injured in Gaza blast near house leveled in summer war - Washington Post: New York Times4 dead... http://t.co/7C2qhMwtv5,25,"['injured', 'leveled']",2,4,3,21,injured,0
Unlicensed teen driver among 2 killed in NC crash http://t.co/Woc6AkEHYX,12,"['Unlicensed', 'killed']",2,1,0,11,injured,1
Experienced urogyn trying to help mesh injured women talks the worst offenders. http://t.co/NpOQLkqUP9 @meshnewsdesk,18,"['trying', 'help', 'mesh', 'talks']",4,7,6,11,injured,0
#???? #?? #??? #??? Udhampur terror attack: Militants attack police post 2 SPOs injured - Times of   http://t.co/1KxsGlsTA7,33,"['attack', 'injured']",2,27,26,6,injured,1
Yelp Bolsters Health Care Reviews With Investigative Journalism: Sick and injured patients at a local ER are t... http://t.co/E8aEGOFDY2,23,['are'],1,12,11,11,injured,0
Terrorists attack police post; 2 SPOs injured http://t.co/lXMdiseUCn #YUG,13,['attack'],1,8,7,5,injured,1
Man injured in Radcliff shooting http://t.co/3iYXOoaCW6,8,"['injured', 'shooting']",2,2,1,6,injured,1
Check this @SuryaRay Udhampur terror attack: Militants attack police post 2 SPOs injured:├½Ôûê_ http://t.co/ptq3zMgncK #SuryaRay #India,24,"['Check', 'attack', 'injured']",3,15,14,9,injured,1
Top Stories - Google 4 dead dozens injured in Gaza blast near house leveled in summer war├½Ôûê_ http://t.co/P3o71DZ992,20,"['injured', 'leveled']",2,8,7,12,injured,1
Photos: 17 people killed and over 25 injured in deadly Saudi Mosque suicide attack http://t.co/geEKnwJJSz,18,['killed'],1,9,8,9,injured,1
"http://t.co/qr3YPEkfOe 
Seems they declared war against government..",9,"['Seems', 'declared']",2,1,0,8,injured,0
Harper Woods policeman injured in fight after dead man found in garage: Ronnie Karjo 46 of Macomb Township http://t.co/tUoTICilBi,22,"['injured', 'found']",2,4,3,18,injured,0
Udhampur terror attack: Militants attack police post 2 SPOs injured http://t.co/zMWeCBWVaO,14,['attack'],1,11,10,3,injured,1
I can't believe Blevins got injured falling off a curb. That's something that would happen to me never it expected for a pro player,27,"['believe', 'got', 'falling', ""'s"", 'happen', 'expected']",6,7,6,20,injured,0
Udhampur terror attack: Militants attack police post 2 SPOs injured: Suspected militants tonight attacked a p... http://t.co/FPhFESemyJ,22,"['attack', 'injured', 'tonight']",3,11,10,11,injured,1
Offers : http://t.co/Gl3C1vc88P #8392 Deluxe Toilet Safety Support/Health/Home/Bathroom/Support/Elderly/Injured/S├½Ôûê_ http://t.co/vihdoKScCC,14,['injured'],1,1,0,13,injured,0
Washington Post - 4 dead dozens injured in Gaza blast near house leveled in summer war http://t.co/VjXa13n8Ap,19,"['injured', 'leveled']",2,7,6,12,injured,1
Ogun smugglers engage Customs in shootout├òÔò®: Several persons were allegedly injured on Wednesday when men o... http://t.co/pUXBC2LoYK #RT,23,"['engage', 'were', 'injured', 'o']",4,12,11,11,injured,0
@ChristieC733 please support this Please cosponsor S. 928 and support aid for sick and injured 9/11 responders! #renew911health,21,['cosponsor'],1,16,15,5,injured,0
Terrorists open fire at Udhampur police post 2 SPO's injured firing underway - See more at:... http://t.co/7jmGwOgqnh,22,"['post', 'See']",2,11,10,11,injured,1
4 dead dozens injured in Gaza blast near house leveled in summer war - Washington Post  http://t.co/AXXDCaKzTY #World,21,"['injured', 'leveled']",2,4,3,17,injured,1
4 dead dozens injured in Gaza blast near house leveled in summer war - http://t.co/L53OABEqc9 via http://t.co/q3Izqdk1n0,21,"['injured', 'leveled']",2,4,3,17,injured,1
@TheHammers_ @tonycottee1986 alsowhat if some of the 1st team players got injured?Then Bilic would get slated for playing themhe can't win,26,"['tonycottee1986', 'got', 'injured', 'get', 'slated', 'playing', 'win']",7,14,13,12,injured,0
RT- Udhampur terror attack: Militants attack police post 2 SPOs injured: Suspected militants tonight at... http://t.co/wN414hp9hZ #News,23,"['attack', 'injured']",2,12,11,11,injured,1
Udhampur terror attack: Militants attack police post 2 SPOs injured: Suspected militants tonight attacked a p... http://t.co/cEKbxJmPBj,22,"['attack', 'injured', 'tonight']",3,11,10,11,injured,1
@TOI_India Udhampur terror attack: Militants attack police post 2 SPOs injured: Suspected militants tonight a... http://t.co/EWCkcfBI28,22,"['attack', 'injured', 'tonight']",3,13,12,9,injured,1
#BreakingNews Militants attack Udhampur police post; 2 SPOs injured http://t.co/EqCCrTlnbd,14,['police'],1,11,10,3,injured,1
@WeAreTheNews please support this Please cosponsor S. 928 and support aid for sick and injured 9/11 responders! #renew911health,21,['cosponsor'],1,16,15,5,injured,1
Neelum Valley teen dies in 'dud shell' explosion: MUZAFFARABAD: A teenage boy was killed and his peer was injured├½Ôûê_ http://t.co/GuRdZEPMhu,25,"['was', 'killed', 'was']",3,22,21,3,injured,0
Udhampur terror attack: Militants attack police post 2 SPOs injured: Suspected militants tonight attacked a p... http://t.co/Cwm0ULqu3E,22,"['attack', 'injured', 'tonight']",3,11,10,11,injured,1
@wral there are now 5 fire trucks and 2 ambulances at Wellington ridge lp in Cary. one of the units is on fire. not sure on injuries,30,"['are', 'is']",2,30,29,0,injuries,0
@EdmontonEsks SB Adarius Bowman says team leadership and depth have helped through some key injuries https://t.co/hCnmZsfNcI #yeg,21,"['says', 'have', 'helped']",3,16,15,5,injuries,0
My baby girls car wreak this afternoon thank God no serious injuries and she was wearing her seatbelt!!!... http://t.co/NJQV45ndS2,25,"['thank', 'was', 'wearing']",3,12,11,13,injuries,0
8/5 Arizona Cardinals news: Jaron Brown makes headlines minor injuries continue to build http://t.co/QxKncvlrh1 http://t.co/KJnhNPMxGr,20,"['makes', 'continue', 'build']",3,11,10,9,injuries,0
Tonight we have attended a fire in Romford with @LondonFire thankfully no injuries http://t.co/iyjeJop2WI,17,"['have', 'attended', 'http']",3,14,13,3,injuries,0
Peel police say male cyclist struck near Southdown Road and Royal Windsor Drive in Mississauga. Serious but non life-threatening injuries.,22,['say'],1,21,20,1,injuries,0
West Nyack Pineview Road railroad crossing off Western Highway. Units on scene of a CSX Train vs. truck no injuries.,22,['crossing'],1,21,20,1,injuries,0
San Francisco 0 I80 E **Hit and Run No Injuries** http://t.co/lp9TBu7KzH,13,['injuries'],1,1,0,12,injuries,0
#BreakingNews Mva / Multiple Injuries - Saint Petersburg FL: E7 requesting R7 &amp; 2 sunstar units for injuries├½Ôûê_ http://t.co/0XRysEpQhL,25,['requesting'],1,22,21,3,injuries,1
Accident with injuries on #NJ36 SB at CR 516/Leonardville Rd http://t.co/2xwIHy2wsg,14,['injuries'],1,3,2,11,injuries,1
Carterville High School coaches prepare for game-day injuries http://t.co/kKiMMBUe04,11,['prepare'],1,8,7,3,injuries,0
Let's be thankful most of these injuries are minor &amp; it's still camp. Relax a little #birdgang. No one is cursed &amp; no injury bug hit.,36,"['Let', 'be', 'are', ""'s"", 'Relax', 'is', 'cursed', 'amp']",8,8,7,28,injuries,0
@msnbc What a fucking idiot. He had a gun &amp; a hatchet yet there were still no serious injuries. Glad police terminated him.,29,"['msnbc', 'had', 'were', 'terminated']",4,23,22,6,injuries,0
Trauma injuries involving kids and sport usually cycling related: Director Trauma NS  http://t.co/8DdijZyNkf #NS http://t.co/52Uus4TFN3,21,"['involving', 'cycling', 'related']",3,2,1,19,injuries,0
No injuries reported after Green Line train derails on South Side http://t.co/nM7HuH3bjC,14,['reported'],1,2,1,12,injuries,0
Enjoying a little golf this summer? Take care to avoid injury -- back and shoulder injuries can happen quickly http://t.co/f1R5ISBVks,23,"['Enjoying', 'avoid', 'happen']",3,17,16,6,injuries,0
CLEARED:incident with injury:I-495  inner loop Exit 31 - MD 97/Georgia Ave Silver Spring,17,['injury'],1,5,4,12,injury,1
CLEARED:incident with injury:I-495  inner loop Exit 31 - MD 97/Georgia Ave Silver Spring,17,['injury'],1,5,4,12,injury,1
Jack Wilshere has poor injury recordand his off field behaviors doesn't help.#Arsenal,15,"['has', 'recordand', 'does', 'help.']",4,5,4,10,injury,0
Traffic Collision - No Injury: I5 S at I5 S 43rd Ave offramp South Sac http://t.co/cT9ejXoLpu,19,['collision'],1,1,0,18,collision,1
incident with injury:I-495  inner loop Exit 31 - MD 97/Georgia Ave Silver Spring,15,['injury'],1,3,2,12,injury,1
California Law├½Ôûê├ïNegligence and Fireworks Explosion Incidents http://t.co/d5w2zynP7b,9,['injury'],1,1,0,8,injury,1
CLEARED:incident with injury:I-495  inner loop Exit 31 - MD 97/Georgia Ave Silver Spring,17,['injury'],1,5,4,12,injury,1
My prediction for the Vikings game this Sunday....dont expect a whole lot. Infact I think Zimmer goal is....injury free 1st game,26,"['.dont', 'expect', 'think', 'is']",4,1,0,25,injury,0
Dante Exum's knee injury could stem Jazz's hoped-for surge back to ... http://t.co/8PIFutrB5U,17,['stem'],1,5,4,12,injury,0
@AdamRubinESPN Familia: arm injury or head case?,10,['injury'],1,6,5,4,injury,0
Ankle injury to keep Spurs├½Ôûê┬¼ Marjanovic out of Eurobasket http://t.co/UBCggEHqyN #spurs #NBA,16,['keep'],1,2,1,14,injury,0
nflweek1picks: Michael Floyd's hand injury shouldn't devalue his fantasy stock: Michael Floyd's damaged digits won... ├½Ôûê_,22,"['devalue', 'damaged', 'won']",3,7,6,15,injury,0
@Sport_EN Just being linked to Arsenal causes injury.,10,"['being', 'linked', 'causes']",3,9,8,1,injury,0
incident with injury:I-495  inner loop Exit 31 - MD 97/Georgia Ave Silver Spring,15,['injury'],1,3,2,12,injury,1
New post: Texans report: QB battle unaffected by Foster&amp;#039;s injury http://t.co/IgH2PAAHnK,22,['unaffected'],1,19,18,3,injury,0
Ben Heenan carted off the field at @Colts training camp.. No word on how serious the injury is #colts #nfl,23,"['carted', 'training', 'is']",3,18,17,5,injury,0
incident with injury:I-495  inner loop Exit 31 - MD 97/Georgia Ave Silver Spring,15,['injury'],1,3,2,12,injury,1
├½Ôûê┬ñWe live in an area that├½Ôûê┬¼s inundated with wildlife...If people don├½Ôûê┬¼t learn how to get along or live with them... http://t.co/KZXV6DWQ6E,26,"['inundated', 'don├½Ôûê┬¼t', 'learn', 'get']",4,7,6,19,inundated,0
"Body shops inundated with cars dented by hail... Good news insurance pays... Bad news :  you are stuck with deductible !
#wcvb",25,"['inundated', 'dented', 'are', 'stuck']",4,3,2,22,inundated,0
As a result of heavy rains in #Bangladeshaffected lands are inundated by flood waters-land looks like rivers at high tide #BangladeshFlood,23,"['are', 'inundated']",2,12,11,11,inundated,1
@Rossifumibhai @alexeeles all 6 of them?! As you can see from the pic they were clearly inundated. Good try though,25,"['alexeeles', 'see', 'were', 'inundated']",4,21,20,4,inundated,0
Myanmar's president urged people to leave a low-lying southern delta region on Thursday with rain water that has inundated much of the coun├½Ôûê_,24,"['urged', 'leave', 'has', 'inundated']",4,20,19,4,inundated,0
This is set to become a huge one month wonder. (And then Pornhub will be inundated....) http://t.co/gghfx8PzMh,24,"['is', 'set', 'become', 'be', 'inundated']",5,18,17,6,inundated,0
@LEDofficial1 As you can imagine we're inundated with requests each week for samples &amp; as much as we'd love to be able to send sweets 1/2,31,"['imagine', ""'re"", 'inundated', 'love', 'be', 'send']",6,9,8,22,inundated,0
@Bilsko and suddenly I'm inundated with research. @humofthecity,12,"[""'m""]",1,7,6,5,inundated,0
.@38_degrees Hello. I have been inundated by people Tweeting me about some Unilever thing in India I know nothing about.,24,"['have', 'been', 'inundated', 'Tweeting', 'know']",5,9,8,15,inundated,0
"Potential Storm Surge Flooding Map by National Hurricane Center http://t.co/JZWRWlVlSj 
http://t.co/oT3bjjhH8s",15,['inundation'],1,1,0,14,inundation,1
#EPAO MARSAC reports on Manipur flood: Heavy incessant rains in Manipur have led to inundation causin... http://t.co/rh7m7T9Gd9 #MANIPUR,24,"['have', 'led', 'inundation']",3,17,16,7,inundation,1
"Punjab government flood relief platform: 

http://t.co/bpG68gXI9k 

realtime information on inundation damages... http://t.co/c8T9ThI7Wd",18,['inundation'],1,13,12,5,inundation,0
Punjab government flood relief platform: http://t.co/vULrClw7Bd realtime information on inundation damages rescue efforts &amp; travel alerts,21,['rescue'],1,13,12,8,inundation,0
@kemal_atlay caught in a landslide,6,['caught'],1,6,5,0,landslide,1
@R_o_M by a landslide.,6,['landslide'],1,5,4,1,landslide,1
TommyGShow: Burlington County offers to purchase landslide-damaged properties in Florence http://t.co/xgguElyxyi,14,"['offers', 'purchase']",2,8,7,6,landslide,0
".Sink Holes Earth Slides And Avalanches&gt;&gt;https://t.co/XrRLnheLaP
#Allah #Islam #sinkhole #landslide #avalanche #USA #France #UK #usgs #emsc",35,['landslide'],1,23,22,12,landslide,0
@MartinMJ22 @YouGov When did a 12 seat majority with 36% of the vote become a landslide?,20,"['did', 'become']",2,19,18,1,landslide,0
Army veteran fears loose rocks from Dundee landslide could kill him at any moment: He has faced a hail of bullets├½Ôûê_ http://t.co/sxmLg3XdvX,25,"['kill', 'has', 'faced']",3,8,7,17,landslide,1
@kdudakia I get that there has been a massive turn away from Labour but that does not = electoral landslide. Credits tories too much and...,28,"['get', 'has', 'been', 'does', '=', 'tories']",6,21,20,7,landslide,0
"Inbounds/ Out of Bounds:

While many picked the Nats to win the NL East in a landslide they currently sit 2... http://t.co/l0dEoCxU6o",26,"['picked', 'win', 'sit']",3,18,17,8,landslide,0
11:30BST traffic: A10&gt;Paris A40 Geneva A7 Mons A1 Hamburg A2&gt;Hanover A5 Karlsruhe Gotthard n/b  http://t.co/yoi9tOCxiQ,26,['landslide'],1,1,0,25,landslide,0
WATCH: Likely landslide victims denied assistance again http://t.co/BxiohtiC5X,11,['denied'],1,4,3,7,landslide,0
Latest: Landslide kills three near Venice after heavy rain http://t.co/BcCcA4VY9R,13,['landslide'],1,1,0,12,landslide,1
FreeBesieged: .MartinMJ22 YouGov Which '#Tory landslide' ... you can't POSSIBLY mean the wafer-thin majority of #G├½Ôûê_ http://t.co/2q3fuEReY5,25,"['FreeBesieged', 'POSSIBLY', 'mean']",3,9,8,16,landslide,0
DUNDEE NEWS: Army veteran fears loose rocks from Dundee landslide could kill him at any moment http://t.co/y7Rv0tiL1w,20,['kill'],1,11,10,9,landslide,1
Method in contemplation of incident an leading bridal landslide: wiWNpFXA http://t.co/xysNXUM29T,14,['leading'],1,9,8,5,landslide,0
being stuck on a sleeper train for 24 hours after de-railing due to a landslide was most definitely the pit of the trip,23,"['being', 'stuck', 'was']",3,15,14,8,landslide,0
#Flashflood causes #landslide in Gilgit #Pakistan Damage to 20 homes farmland roads and bridges #365disasters  http://t.co/911F3IXRH0,22,"['causes', 'farmland']",2,5,4,17,landslide,0
omg it is I can go in dungeons with Landslide Krag now &lt;3,16,"['is', 'go']",2,1,0,15,landslide,0
Italy: Three dead after landslide in the Italian Alps: http://t.co/42MawZb8T9 via @YouTube,17,['landslide'],1,6,5,11,landslide,0
Landslide kills three near Venice after heavy├òÔò®rain http://t.co/q3Xq8R658r,10,['landslide'],1,1,0,9,landslide,1
#CecilTownship seeks emergency repairs to Southpointe Boulevard landslide: http://t.co/ZjJdt3so72,13,['seeks'],1,9,8,4,landslide,1
Imagine a room with walls that are lava lamps.,10,"['Imagine', 'are']",2,8,7,2,lava,0
The sunset looked like an erupting volcano .... My initial thought was the Pixar short Lava http://t.co/g4sChqFEsT,20,"['looked', 'erupting', 'was']",3,1,0,19,lava,0
Check out my Lava lamp dude ???? http://t.co/To9ViqooFv,13,['Check'],1,1,0,12,lava,0
@YoungHeroesID Lava Blast dan Power Red #PantherAttack @CunayyH @TaufikCJ,13,['lava'],1,1,0,12,lava,0
@YoungHeroesID LAVA BLAST dan POWER RED #PantherAttack @Mirmanda11 @evaaaSR,13,['lava'],1,1,0,12,lava,0
Thunder and lightning possible in the Pinpoint Foothill Forecast. http://t.co/CtIjdPXABk,13,['lightning'],1,3,2,10,lightning,0
It doesn't get any closer. Heavy rain just barely missed @TontitownGrape festival but lightning TOO CLOSE #TGF2015 http://t.co/S53zvMS5Rf,24,"['does', 'get', 'missed', 'lightning']",4,17,16,7,lightning,0
Science Info #JGF Lightning reshapes rocks at the atomic level http://t.co/R5MwlzvVHA,14,['reshapes'],1,1,0,13,lightning,0
World War II book LIGHTNING JOE An Autobiography by General J. Lawton Collins http://t.co/a7iqMhvLSm http://t.co/b9vTkDjJ33,19,['lightning'],1,1,0,18,lightning,0
It doesn't get any closer. Heavy rain just barely missed @TontitownGrape festival but lightning TOO CLOSE #TGF2015 http://t.co/d9PQIXaTX6,24,"['does', 'get', 'missed', 'lightning']",4,17,16,7,lightning,0
The Lightning out here is something serious!,8,"['Lightning', 'is']",2,1,0,7,lightning,0
Couple storms near Guthrie OK. Leaving Norman for an evening lightning op. #okwx http://t.co/HcwrK81p71,18,['lightning'],1,11,10,7,lightning,1
NWS says thunderstorms with deadly lightning will move across the Black Hills this evening. That assumes there's a safe type. Hmm?,25,"['says', 'move', 'assumes', ""'s""]",4,6,5,19,lightning,1
@random_tourist it rained. Some guys tree hit by lightning and some jackholes drove onto flooded streets.,19,"['rained', 'tree', 'hit', 'lightning', 'drove', 'flooded']",6,11,10,8,lightning,1
Expect gusty winds heavy downpours and lightning moving northeast toward VA now. http://t.co/jyxafD4knK,16,"['winds', 'lightning', 'moving']",3,7,6,9,lightning,1
Science Daily: Lightning reshapes rocks at the atomic level - A lightning strike can reshape a mineral's crystal s... http://t.co/TEZLTqeyw2,25,"['Lightning', 'reshape']",2,13,12,12,lightning,0
Don't blink ?? won't see the Lightning take the W ?? http://t.co/D4c2iqiRnU,18,"['Do', 'blink', 'see', 'take']",4,1,0,17,lightning,0
Southeast Regional is in a lightning delay. Buckle up folks this is gonna take awhile.,18,"['is', 'is', 'take']",3,6,5,12,lightning,0
Lightning express golf trolleys fix ramify pretty much multitudinal areas on thine disposed: kWXGgt,15,"['Lightning', 'fix', 'ramify', 'disposed']",4,1,0,14,lightning,0
Heavy rain gusty winds and vivid lightning moving east through the Triad now. http://t.co/JMu5uyamdu,17,"['lightning', 'moving']",2,7,6,10,lightning,1
Lightning causes six new fires on Vancouver├òÔò®Island http://t.co/VdILiiCyR5,10,['Lightning'],1,1,0,9,lightning,1
Expect gusty winds heavy downpours and lightning moving northeast toward VA now. http://t.co/Z5cfrWado6,16,"['winds', 'lightning', 'moving']",3,7,6,9,lightning,1
Dry thunderstorms with lightning possible in the Pinpoint Valley Forecast. http://t.co/IdASYJybrO http://t.co/gdoAOLPq91,17,['lightning'],1,4,3,13,lightning,0
World War II book LIGHTNING JOE An Autobiography by General J. Lawton Collins http://t.co/ihxkforg4I http://t.co/jD6lcRuOHA,19,['lightning'],1,1,0,18,lightning,0
It doesn't get any closer. Heavy rain just barely missed @TontitownGrape festival but lightning TOO CLOSE #TGF2015 http://t.co/zMtOp65Kx2,24,"['does', 'get', 'missed', 'lightning']",4,17,16,7,lightning,0
Cell Phone Shop : http://t.co/iOq051t5te #629 8-Pin Lightning Connector 2.1A Car Charger For Apple 5 5S 5C 6 6+ i├½Ôûê_ http://t.co/klxAUcNP5I,26,['lightning'],1,1,0,25,lightning,0
World War II book LIGHTNING JOE An Autobiography by General J. Lawton Collins http://t.co/R4khEH7iaf http://t.co/qSZgJfUutu,19,['lightning'],1,1,0,18,lightning,0
Lightning strike in the distance via /r/pics http://t.co/iDmhSwewQw #pics,12,['Lightning'],1,1,0,11,lightning,1
Lightning http://t.co/9DQhdEi357,4,['Lightning'],1,1,0,3,lightning,1
Lightning strike in the distance via /r/pics http://t.co/iDmhSwewQw #pics http://t.co/wwxcOB52zI,15,['Lightning'],1,1,0,14,lightning,1
Check this out! Lightning reshapes rocks at the atomic level http://t.co/l1gH8064YV #scichat #science,18,"['Check', 'Lightning']",2,1,0,17,lightning,0
Soon to be loud bang as backpack detonated.,9,"['be', 'detonated']",2,1,0,8,loud bang,0
@Chibi877 --head. It hit the wall behind him with a loud bang. 'Language!' Drake shouted at him before getting up. 'I'm going out stay--,34,"['hit', 'shouted', 'getting', ""'m"", 'going']",5,1,0,33,loud bang,0
tianta_: Breaking news! Unconfirmed! I just heard a loud bang nearby. in what appears to be a blast of wind from my neighbour's ass.,30,"['Unconfirmed', 'heard', 'appears', 'be']",4,1,0,29,loud bang,0
Nearly had a heart attack just now; loud bang against window next to me├½Ôûê_turns out it was two birds flying into the glass.,25,"['had', 'me├½Ôûê_turns', 'was', 'flying']",4,1,0,24,loud bang,0
kiilud: Breaking news! Unconfirmed! I just heard a loud bang nearby. in what appears to be a blast of wind from my neighbour's ass.,30,"['Unconfirmed', 'heard', 'appears', 'be']",4,1,0,29,loud bang,1
Jrowah: Breaking news! Unconfirmed! I just heard a loud bang nearby. in what appears to be a blast of wind from my neighbour's ass.,30,"['Unconfirmed', 'heard', 'appears', 'be']",4,1,0,29,loud bang,1
I WAS PEACEFULLY SITTING IN MY ROOM AND I HEARD THIS LOUD BANG OF SOMETHING FALLING,16,"['WAS', 'PEACEFULLY', 'HEARD']",3,1,0,15,loud bang,0
Man Hears a Loud 'Bang' Finds a Newborn Baby in a Dumpster http://t.co/W815ol0mBV via @ijreview,19,"['Hears', 'Finds']",2,1,0,18,loud bang,0
daviesmutia: Breaking news! Unconfirmed! I just heard a loud bang nearby. in what appears to be a blast of wind from my neighbour's ass.,30,"['Unconfirmed', 'heard', 'appears', 'be']",4,1,0,29,loud bang,1
"St steel coffee cafetiere exploded this am with loud bang hot coffee &amp; grounds shot over table clean crockery phone
tablet. How?",26,"['exploded', 'am', 'shot']",3,1,0,25,loud bang,0
@samanthaturne19 It was... Nagaski another act of mass murder sanctioned and forgiven cause the Allies won... Not by me.,23,"['samanthaturne19', 'was', 'sanctioned', 'cause', 'won']",5,1,0,22,mass murder,0
@TANSTAAFL23 It's not an 'impulse' and it doesn't end in mass murder. Correlation does not imply causation.,23,"[""'s"", 'does', 'end', 'does', 'imply']",5,1,0,22,mass murder,0
@ColdMpress You up to commiting mass murder tonight?,10,"['up', 'commiting']",2,1,0,9,mass murder,0
The media needs to stop publicizing mass murder. So many sick people do these things for the eyes of the world &amp; the media is not helping.,31,"['needs', 'stop', 'publicizing', 'do', 'is', 'helping']",6,1,0,30,mass murder,0
@samanthaturne19 IIt may logically have been the right call... maybe... But it's an act of mass murder and I can't sanction it.,28,"['have', 'been', ""'s"", 'sanction']",4,1,0,27,mass murder,0
We have different moral systems. Mine rejects the mass murder of innocents yours explicitly endorses such behavior. https://t.co/qadRKEJZ9T,22,"['have', 'rejects', 'endorses']",3,1,0,21,mass murder,0
@DoctorDryadma mass murder here we come,7,['come'],1,1,0,6,mass murder,0
If abortion is murder then blowjobs are cannibalism and masturbation is mass genocide.,14,"['is', 'are', 'is']",3,1,0,13,mass murder,0
@D1ff3r3nt1sG00d @RiceeChrispies What if he committed a mass murder?,12,['committed'],1,1,0,11,mass murder,0
@tuicruises @aida_de Cruise Industry Supports Mass Murder of Whales in #Faroe Islands!! 'Everything the (cont) http://t.co/3a3FGZFmzh,25,"['@', 'Islands', ""'Everything""]",3,1,0,24,mass murder,0
Watching Murder in the First and you get the perspective from the family of the mass shooter person...it's crazy the pain they're in...,28,"['Watching', 'get', ""'s"", ""'re""]",4,1,0,27,mass murder,0
RedScareBot: Duck and Cover! RT tanstaafl23: noah_anyname Socialism means mass murder. Houze that for 'correlation'?,21,['means'],1,1,0,20,mass murder,0
Hiroshima - one of history's worst examples of mass murder  http://t.co/TmogTi6FB4 #hiroshima #war #atombomb #japan,22,['mass murder'],1,1,0,21,mass murder,0
70 yrs since the atomic bombing of Hiroshima... Terrible mass murder...,13,['bombing'],1,6,5,7,bombing,0
'Prompt and utter' mass murder  https://t.co/BRU7t5UzUy,9,['mass murder'],1,1,0,8,mass murder,0
@guardian Has Japan ever truly come to terms with devastation and mass murder of millions of Chinese and others with traditional weapons?,24,['come'],1,1,0,23,mass murder,0
Plane debris is from #MH370 - it was a controlled crash. In other words it was mass murder by a musim http://t.co/J3xFDg9CWF @newscomauHQ,28,"['is', 'was', 'was', 'mass']",4,1,0,27,mass murder,0
Oh the usual. Mass murder and world domination plans over coffee. How's your day going?,19,['going'],1,1,0,18,mass murder,0
@Rawrheem: I can give you verses directly from the Qur'an that mandate terrorism mass-murder mass-rape genocide etc. Would you like them?,25,"['give', 'mandate', 'like']",3,1,0,24,mass murder,0
http://t.co/c1H7JECFrV @RoyalCarribean do your passengers know about the mass murder that takes place in the #FaroeIslands every year?,23,"['do', 'know', 'takes']",3,1,0,22,mass murder,0
@noah_anyname The utopian impulse inevitably ends in gulags and mass murder.,13,"['noah_anyname', 'ends']",2,1,0,12,mass murder,0
Urgent! Save the Salt River #WildHorses! Mass murder by the very ppl supposed to protect them?  --&gt; http://t.co/14wH0pJJ2C @CNN @CBC,31,"['Save', 'WildHorses', 'supposed', 'protect']",4,1,0,30,mass murder,1
@FLGovScott We allow Farrakhan to  to challenge 10000 males to rise up &amp; commit mass murder as he just did in Miami? http://t.co/gV84WNhB7S,29,"['allow', 'challenge', 'rise', 'did']",4,1,0,28,mass murder,0
http://t.co/c1H7JECFrV @RoyalCarribean do your passengers know about the mass murder that takes place in the #FaroeIslands every year?,23,"['do', 'know', 'takes']",3,1,0,22,mass murder,0
@yelllowheather controlled murder is fine. mass murder to a crowd of undeserving people isn't. case closed.,21,"['is', 'is', 'closed']",3,1,0,20,mass murder,0
@Re_ShrimpLevy I'm always up for mass murder,9,"[""'m""]",1,1,0,8,mass murder,0
@JakeGint the mass murder got her hot and bothered but at heart she was always a traditionalist.,19,"['got', 'bothered', 'was']",3,1,0,18,mass murder,0
@Conservatexian Farrakhan calling for 10000 men to rise up &amp; commit mass murder. http://t.co/gV84WNhB7S,20,"['calling', 'rise']",2,1,0,19,mass murder,0
@Cynicalreality when the subject is mass murder. @LetsBe_Rational @MishaWeller @llr517,15,['is'],1,1,0,14,mass murder,0
Today marks 70 years since the mass murder of 140000 civilians in Hiroshima. The bombing of Hiroshima and Nagasaki did NOT end WW2,24,"['marks', 'did', 'end']",3,1,0,23,mass murder,0
@MNPDNashville @MontalbanoNY sadly suicide by cop. Wed 2PM @ Dollar movie does not a mass murder make.,21,['does'],1,1,0,20,mass murder,0
@billy_hodge Aurora theater shooting trial: Gunman expected notoriety for mass murder and nothing else  http://t.co/1RPCHRu72C,19,"['shooting', 'expected']",2,1,0,18,mass murder,0
"#DebateQuestionsWeWantToHear Why does #Saudi arabia and #Israel get away with mass murder?
#Wahhabism #Zionism",20,"['does', 'get']",2,1,0,19,mass murder,0
Amazing how smug this guy is about the use of mass murder as a global power play. https://t.co/AlTTBJy8B9,21,['is'],1,1,0,20,mass murder,0
Like bro they just committed a mass murder. You think they're gonna be scared to get guns illegally ????,25,"['committed', 'think', ""'re"", 'gon', 'be', 'scared', 'get']",7,1,0,24,mass murder,0
Okay not sure the word 'mass murder' applies during this war but it was horrendous none the less. https://t.co/Sb3rjQqzIX,23,['was'],1,1,0,22,mass murder,0
Another white guy trying to mass murder people for no apparent reason just because let me guess he's mentally ill blah blah blah #Antioch,26,"['trying', 'mass', 'let', 'guess', ""'s""]",5,1,0,25,mass murder,0
Hiroshima: 70 years since the worst mass murder in human history. Never forget. http://t.co/jLu2J5QS8U,19,['mass murder'],1,1,0,18,mass murder,0
RT greta: Movement to impeach SA Pres #Zuma ├½Ôûê├è accused of helping mass murderer Pres #Bashir of #Sudan escape #geno├½Ôûê_ http://t.co/pnxhxlX9uP,28,"['impeach', 'accused', 'helping']",3,1,0,27,mass murderer,0
Asad is also a mass murderer.  https://t.co/dZOReZpxvR,10,['is'],1,1,0,9,mass murderer,0
Kach was a group to which belonged Baruch Goldstein a mass murderer who in 1994 shot and killed 29 Palestinian├½Ôûê_ http://t.co/bXGNQ57xvb,23,"['was', 'belonged', 'killed']",3,1,0,22,mass murderer,0
Sooooo shooting up movie theaters the new mass murderer wave??,12,"['shooting', 'wave']",2,1,0,11,mass murderer,0
@TrillAC_ I think we've only had like one black mass murderer in the history of mass murders white people do that shit.,25,"['think', ""'ve"", 'had', 'do']",4,1,0,24,mass murderer,0
Mass murderer Che Guevara greeting a woman in North Korea http://t.co/GlJBNSFGLl',14,['greeting'],1,1,0,13,mass murderer,0
#gunsense answer to #GFZ's: break law on the minuscule chance a mass murderer shows up. https://t.co/qEoPMCJbCz,23,['shows'],1,1,0,22,mass murderer,0
#TheaterShooting DEFENDANT/MASS MURDERER CHOSE NOT 2 TESTIFY IN FINAL PHASE 3 so he won't therefore B subject 2 cross-exam or jury questions,24,"['TheaterShooting', 'therefore']",2,1,0,23,mass murderer,0
White people I know you worry tirelessly about black on black crime but what are you going to do about your mass murderer problem?,25,"['know', 'worry', 'are', 'going', 'do']",5,1,0,24,mass murderer,0
You happen to conveniently 'forget' about how you Zionists revere and 'honour' mass murderer Baruch Goldstein.  https://t.co/3KOB7xBeA0,22,"['happen', ""'forget"", 'Zionists']",3,1,0,21,mass murderer,0
Hey #movietheatre mass murderer wanna-be we don't play that shit in the #615!,17,"['do', 'play']",2,1,0,16,mass murderer,0
Julian Knight - @SCVSupremeCourt dismisses mass murderer's attempt to increase prisoner pay. Challenged quantum of 5% increase 2013.,23,"['dismisses', 'mass', 'increase']",3,1,0,22,mass murderer,0
@bettyfreedoms @AbnInfVet hillary mass murderer.,8,['@'],1,1,0,7,mass murderer,0
"Reminder: Mass murderer and white supremacist Anders Breivik was also unsurprisingly an anti-feminist.
http://t.co/1lXnJVl8TR",18,['was'],1,1,0,17,mass murderer,0
So wait he really not gonna tell his wife that he is a mass murderer now and a cheat #derailed @itv2...I'm done with this film ????,35,"['gon', 'tell', 'is', 'derailed', ""'m"", 'done']",6,1,0,34,mass murderer,0
I am disgusted by @libertarianism and @CatoInstitute for celebrating a mass murderer of innocents today.,18,"['am', 'disgusted', 'celebrating']",3,1,0,17,mass murderer,0
Happy boy to mass murderer http://t.co/xPddWH5teM,8,['mass'],1,1,0,7,mass murderer,0
@NeanderRebel If you take the suit off him I wouldn't be surprised to hear this is the face that belonged to another democrat mass-murderer,26,"['take', 'be', 'surprised', 'hear', 'is', 'belonged']",6,1,0,25,mass murderer,0
Has gun law ever dissuaded a potential mass murderer?,10,['dissuaded'],1,1,0,9,mass murderer,0
Another White mass murderer. Thank God I live in California.  https://t.co/4COg0OTiWn,15,['live'],1,1,0,14,mass murderer,0
Mass murderer had sex without touching each other or taking their clothes off because he was so fanatical on hygiene http://t.co/RfewQRGzbs,23,"['had', 'touching', 'taking', 'was']",4,1,0,22,mass murderer,0
Another White mass murderer. Thank God I'm from California. @FrauTrapani,14,"[""'m""]",1,1,0,13,mass murderer,1
Sounds pretty sensible for a mass murderer... https://t.co/qZZxFYSIU1,11,['mass murderer'],1,1,0,10,mass murderer,0
Nazi Mass Murderer Became Chairman At Vaccine Drug Company In... http://t.co/x713OMh6Ai,14,['mass murderer'],1,1,0,13,mass murderer,0
Another White mass murderer. #Antioch  https://t.co/OWpd7vcFS6,10,['mass murderer'],1,1,0,9,mass murderer,1
Just now convicted mass murderer James Holmes told the judge he won't use his right to ask jury for mercy in his own words. #TheaterTrial,28,"['convicted', 'told', 'use', 'ask']",4,1,0,27,mass murderer,0
@blairmcdougall and when will you be commenting on Ian Taylor's dealings with mass - murderer Arkan?,19,"['be', 'commenting']",2,1,0,18,mass murderer,0
@Phoenix_Blue People will create rumors no matter what. The bottom line is giving fifteen minutes of fame to a mass murderer does no good.,27,"['create', 'is', 'giving', 'does']",4,1,0,26,mass murderer,0
@AFK_10 @Dr_JohanFranzen ISIS are orchs. But they don't have the ability to massacre civilians far from the frontlines like the tyrant.,26,"['are', 'do', 'have', 'massacre']",4,17,16,9,massacre,0
"@Cameron_WATE
 Parents of Colorado theater shooting victim fear copycat massacre

http://t.co/LvlH3W3aWO
#Antioch

http://t.co/vIwXY1XDYK",19,['shooting'],1,11,10,8,massacre,0
UK police link Tunisian beach massacre with Bardo museum attack http://t.co/1fVoOTqnEj,13,['link'],1,6,5,7,massacre,0
Baby elephant dies just days after surviving massacre of his family http://t.co/qzCUT7bVKT,14,['surviving'],1,8,7,6,massacre,0
"@abc3340 
Parents of Colorado theater shooting victim fear copycat massacre

http://t.co/LvlH3W3aWO
#Antioch

http://t.co/vIwXY1XDYK",19,['shooting'],1,11,10,8,massacre,0
1 TRILLION Dollar Lawsuit Filed Against MSM For 'Staging Sandy Hook Massacre' http://t.co/qutzvk9xoP,16,"[""'Staging""]",1,1,0,15,massacre,0
3 Years After the Sikh Temple Massacre Hate-Violence Prevention Is Key | @dviyer @Colorlines http://t.co/nLbLtYnV36 http://t.co/bjrrqHHoHL,22,['massacre'],1,1,0,21,massacre,0
"Massacre at #Sinjar : Has the World Forgotten the #Yazidi ?
http://t.co/WUh1g2BLP1
#??_????_????? #yazidi_shingal_genocide #EzidiGenocide",34,"['Has', '_', '_']",3,1,0,33,massacre,0
3 Years After the Sikh Temple Massacre Hate-Violence Prevention Is Key | Colorlines http://t.co/iJoORKaGyj,16,['massacre'],1,1,0,15,massacre,0
Colorado movie massacre trial jurors reach verdict on mitigating factors http://t.co/75VLsw85GI http://t.co/txY3US2Ejs,16,"['reach', 'mitigating']",2,3,2,13,massacre,0
Still Uninvestigated After 50 Years: Did the U.S. Help Incite the 1965 Indonesia Massacre? http://t.co/EZbTG81trz,19,['Uninvestigated'],1,1,0,18,massacre,0
"@KabarMesir @badr58 
Never dies a big Crime like RABAA MASSACRE as long the revolution is being observed.
#rememberRABAA",22,"['badr58', 'dies', 'is', 'being', 'observed']",5,1,0,21,massacre,0
Bestie is making me watch texas chainsaw massacre ????????,16,"['is', 'making', 'watch']",3,8,7,8,massacre,0
Petition/No Medals for 1890 Massacre Justice for Wounded Knee Killings of Native Americans! http://t.co/UilPg8i1ev http://t.co/m9pXTo2kwW,20,['massacre'],1,1,0,19,massacre,0
I see a massacre!!,6,['see'],1,4,3,2,massacre,0
"@WCBD 
Parents of Colorado theater shooting victim fear copycat massacre

http://t.co/LvlH3W3aWO
#Antioch

http://t.co/vIwXY1XDYK",19,['shooting'],1,11,10,8,massacre,0
"Headed to the massacre 
Bodies arriving everyday 
What were those shells you heard 
Picking the bones up along the way",20,"['Headed', 'arriving', 'were', 'heard', 'Picking']",5,4,3,16,massacre,0
The Fake of Nanking Massacre-4 Eyewitnesses (English): http://t.co/TiPnDEmPuz  #Obama #Clinton #Bush #GOP #ABC #CBS #BBC #CNN #WSJ #WPO,33,['massacre'],1,1,0,32,massacre,0
Remember this was a massacre of civilians. #Hiroshima http://t.co/qw8qk165Sb,13,['was'],1,5,4,8,massacre,0
Tunisia beach massacre linked to March terror attack on museum http://t.co/kuRqLxFiHL,13,['linked'],1,3,2,10,massacre,0
What person would possibly make a horror film about the Isla Vista massacre in order to make money off of our tragedy?,23,"['make', 'make']",2,13,12,10,massacre,0
@freddiedeboer @Thucydiplease then you have rise of Coates Charleston massacre Walter Scott and black twitter more broadly as well.,22,['have'],1,12,11,10,massacre,0
@gigagil IOF murdered over 513 Palestinian children (70% under 12) during Gaza Massacre where was zionist morality-zionism is a world evil!,26,"['murdered', 'was', 'is']",3,1,0,25,massacre,0
Sousse beach massacre linked to Tunis museum attack http://t.co/MyHHTHsLi3,11,['linked'],1,3,2,8,massacre,0
One Year After Massacre Iraq├½Ôûê┬¼s Yazidis a Broken People http://t.co/pHqK28doni,12,['massacre'],1,1,0,11,massacre,0
Tell @BarackObama to rescind medals of 'honor' given to US soldiers at the Massacre of Wounded Knee. SIGN NOW &amp; RT! https://t.co/u4r8dRiuAc,30,"['rescind', 'given', 'US']",3,1,0,29,massacre,0
"@nataliealund 
Parents of Colorado theater shooting victim fear copycat massacre

http://t.co/LvlH3W3aWO
#Antioch

http://t.co/vIwXY1XDYK",19,['shooting'],1,11,10,8,massacre,0
The same UN who stood&amp;watched the Serbs massacre thousands of muslims in Yougslavia ?don't need any lessons off them https://t.co/Ubf3CFzfEX,28,"['stood', 'watched', 'do', 'need']",4,12,11,16,massacre,0
"TimesNewsdesk : Police link beach massacre to Tunisia museum attack
├½Ôûê_ http://t.co/g11Rd44rgW) http://t.co/n834UntFf1",18,['link'],1,6,5,12,massacre,1
"@WKRN 
Parents of Colorado theater shooting victim fear copycat massacre

http://t.co/LvlH3W3aWO
#Antioch

http://t.co/vIwXY1XDYK",19,['shooting'],1,11,10,8,massacre,0
Letter after Glencoe Massacre Scotland ' Who will provide me with meat for my table ? Now that my red haired warrior is gone forever ',26,"['provide', 'is', 'gone']",3,1,0,25,massacre,0
@MartynWaites It's a well-known fact that the St Valentine's Day massacre could have been avoided with some 'oompah-period' Tom Waits.,25,"['MartynWaites', ""'s"", 'have', 'been', 'avoided']",5,14,13,11,massacre,0
Thus ends the clam massacre of 2015. #clambake #showgirldayoff https://t.co/PtyUJJi67T,15,['ends'],1,5,4,10,massacre,0
The Martyrs Who Kept Udhampur Terrorists at Bay Averted a Massacre: It was two young├½Ôûê_ http://t.co/nux5XfPV2d SPS├ò┬┐,20,"['Terrorists', 'was']",2,1,0,19,massacre,0
Saturday Night Massacre ? 25 Years Later #TomLandry?s Firing Still A Day of Infamy http://t.co/MlA71Y7mMW,20,['massacre'],1,1,0,19,massacre,0
I liked a @YouTube video from @itsjustinstuart http://t.co/oDV3RqS8JU GUN RANGE MAYHEM!,16,['liked'],1,1,0,15,mayhem,0
'Mumbai attack mayhem was planned and launched from Pakistan'Ex-Federal Investigation Agency (FIA) chief Tariq Khosa. http://t.co/xzSP5JhVfc,21,"['was', 'planned', 'launched']",3,3,2,18,mayhem,0
Asbury Park shooting reported http://t.co/dADZ5ZFO1g via @AsburyParkPress,10,"['shooting', 'reported']",2,1,0,9,mayhem,0
PNC Bank Arts Center shooting: Holmdel man nabbed http://t.co/tvmD14uikO,12,['nabbed'],1,1,0,11,mayhem,0
El Nino is getting stronger! Monster weather system may bring relief to California but it could cause 'mayhem' el├½Ôûê_ http://t.co/A9PoFHBbjf,24,"['is', 'getting', 'bring', 'cause']",4,1,0,23,mayhem,0
BREAKING: Authorities respond to Ocean fire http://t.co/h31Knuwzz5,10,['respond'],1,1,0,9,mayhem,1
The ol' meltdown victory for the Mets.,9,['meltdown'],1,4,3,5,meltdown,0
@tinybaby @adultblackmale @mattytalks meltdown mwednesday,8,['meltdown'],1,7,6,1,meltdown,0
THE GLOBAL ECONOMIC MELTDOWN is out! http://t.co/DGATKRdyNy Stories via @seagull07 @AleisStokes @intelligencebar,18,"['is', 'seagull07']",2,1,0,17,meltdown,0
Commodities├òÔò®Are Crashing Like It's 2008 All Over Again http://t.co/EM1cN7alGk,12,"[""'s""]",1,1,0,11,meltdown,0
@ChelseaVPeretti's bit on @meltdown_show was also gold.,11,['was'],1,7,6,4,meltdown,0
"Byproduct of #metal price meltdown is a higher #silver price
http://t.co/KBC2Ax8Zl9",15,['is'],1,6,5,9,meltdown,0
Byproduct of metal price meltdown is a higher silver price http://t.co/cZWjw4UV7i,13,['is'],1,5,4,8,meltdown,0
President Barack Obama has on air meltdown over opposition to Iran nuclear deal http://t.co/c0t7RvoTKj via @examinercom,19,"['has', 'meltdown']",2,7,6,12,meltdown,0
Inspectors So Far Denied Access to Iran's Scientists - Wall Street Journal http://t.co/SuR3odwMKa http://t.co/2VSX1yO5hT,19,['military'],1,1,0,18,military,0
Texian Iliad: A Military History of the Texas Revolution by Hardin Stephen L. http://t.co/RrIDS0mrJ1 http://t.co/wybtUk7LbG,20,['military'],1,1,0,19,military,0
Senator 'alarmed' by reports U.S. military families harassed: A U.S. Senator said on Wednesday he was alarmed by├½Ôûê_ http://t.co/sbILA2Yqjq,24,"[""'alarmed"", 'harassed', 'said', 'was', 'alarmed']",5,7,6,17,military,0
@UnivSFoundation For the people who died in Human Experiments by Unit 731 of Japanese military http://t.co/vVPLFQv58P http://t.co/Rwaph6dAUv,22,['died'],1,16,15,6,military,0
@kiranahmedd US military and Nato are fighting Talibans too,10,"['kiranahmedd', 'are', 'fighting']",3,4,3,6,military,0
@SocialJerkBlog My husband was in the military and he does that. It ends up in seat shuffling sometimes. ;),23,"['was', 'does', 'ends']",3,8,7,15,military,0
@stfxuniversity For the people who died in Human Experiments by Unit 731 of Japanese military http://t.co/vVPLFQv58P http://t.co/l5AWTUndhm,22,['died'],1,16,15,6,military,0
@2for1Lapdances For the people who died in Human Experiments by Unit 731 of Japanese military http://t.co/vVPLFQv58P http://t.co/yOMPxJpPTV,22,['died'],1,16,15,6,military,0
Courageous and honest analysis of need to use Atomic Bomb in 1945. #Hiroshima70 Japanese military refused surrender. https://t.co/VhmtyTptGR,23,"['use', 'refused']",2,17,16,6,military,0
Obama warns there will be another war without Iran deal #military http://t.co/gM7QlTRLuW http://t.co/wTutMlHDMH,18,"['warns', 'be']",2,12,11,6,military,0
@UniversityofLaw For the people who died in Human Experiments by Unit 731 of Japanese military http://t.co/vVPLFQv58P http://t.co/eG1fsKqBv6,22,['died'],1,16,15,6,military,0
@CochiseCollege For the people who died in Human Experiments by Unit 731 of Japanese military http://t.co/vVPLFQv58P http://t.co/ldx9uKNGsk,22,['died'],1,16,15,6,military,0
'It looks like a mudslide!' And #GBBO is back with a belter!,16,['is'],1,5,4,11,mudslide,1
STERLING-SCOTT on the Red Carpet at a fundraiser for 'OSO Mudslide' https://t.co/mA4ra7AtqL http://t.co/cg579wlDnE,18,['mudslide'],1,1,0,17,mudslide,0
#Tajikistan #Mudslides #China aids to #Mudslide-hit #Tajiks http://t.co/BD546mtcpN,15,['mudslide'],1,1,0,14,mudslide,1
Paul Hollywood 'what happened....looks like a mudslide... It's like chewing on a rubber tyre... It looks a mess...' Oh dear Dorrett! #GBBO,31,"['happened', ""'s"", 'chewing', 'looks']",4,9,8,22,mudslide,0
@marc_holl @NenniCook @AitchKayCee @vixstuart @benjbeckwith It's not pretty ??#disaster #GBBO #mudslide,22,"['benjbeckwith', ""'s""]",2,22,21,0,mudslide,0
'It looks like a mudslide' poor thing! ?? #greatbritishbakeoff,13,['mudslide'],1,5,4,8,mudslide,1
Flood and Mudslide Warning for East Fjords | Iceland Review http://t.co/534q3Jg2OV #icelandreview via @iceland_review,18,['mudslide'],1,1,0,17,mudslide,1
@SophieWisey I couldn't. #mudslide,8,['mudslide'],1,8,7,0,mudslide,0
@picniclester it was a mudslide,6,['was'],1,6,5,0,mudslide,0
@brobread looks like mudslide????,9,['mudslide'],1,5,4,4,mudslide,0
"@Lolly_Knickers It's a mudslide. 
It's like chewing on a rubber tyre.
And with those I'm DONE.
#vaginaorcake #GBBO",27,"['Lolly_Knickers', ""'s"", ""'s"", 'chewing', ""'m""]",5,6,5,21,mudslide,0
@new_hart2010 #mudslide... nuff said #GBBO,9,['said'],1,4,3,5,mudslide,0
Oso Washington Mudslide Response Interview ├½Ôûê├è Part 1 http://t.co/sbfGLQjZfs,11,['mudslide'],1,1,0,10,mudslide,0
@melindahaunton mudslide lady is a good shout,8,['is'],1,3,2,5,mudslide,0
First time getting into #gbbo2015 and physically gasped at the cake 'mudslide' incident already way too emotionally invested...,21,"['getting', 'gasped', 'invested']",3,1,0,20,mudslide,0
@Doylech They're refugees: 'people who have been forced to leave their country in order to escape war persecution or natural disaster',25,"[""'re"", 'have', 'been', 'forced', 'leave', 'escape']",6,1,0,24,natural disaster,0
On the sneak America has us spoiled. A natural disaster will humble niggas.,15,"['has', 'spoiled', 'humble']",3,1,0,14,natural disaster,0
RaÔòáÔòØl sends a message of condolence to Vietnam following natural disaster http://t.co/bgyTmqJ3OO,14,"['sends', 'following']",2,1,0,13,natural disaster,0
@patrickandsam @ghaccount I've been screaming natural disaster for months but now idk. Maybe a hospital crisis.,21,"[""'ve"", 'been', 'screaming', 'idk']",4,1,0,20,natural disaster,0
@Cali74142290 lol natural disaster/hospital crisis something is needed to get rid of some cast members....,18,"['lol', 'is', 'needed', 'get']",4,1,0,17,natural disaster,0
Some people are really natural disaster too,7,['are'],1,1,0,6,natural disaster,0
Coming later this year~ 'THE MAN THAT TATTOOED WOMEN.' A novel based on a real serial killer from #Arkansas &amp; a natural disaster. #NOLA,31,"['Coming', 'year~', 'based']",3,1,0,30,natural disaster,0
RaÔòáÔòØl sends a message of condolence to Vietnam following natural disaster: On behalf of the Cuban government an... http://t.co/EmrZiCb004,23,"['sends', 'following']",2,1,0,22,natural disaster,0
Home Inventories Can Help all Homeowners  in Case of Natural Disaster - ABC News http://t.co/RNWvkBkhWU via @ABC,20,['natural disaster'],1,1,0,19,natural disaster,0
#Nepal Magnitude 4.3 tremor rattles #Dolakha as #aftershock counts 367 | Recent Natural Disasters : http://t.co/Re1d5ffcSx,21,['counts'],1,1,0,20,natural disaster,1
Expert Prepper: Financial Collapse Natural Disaster Failed Grid... http://t.co/AVVSOiNO8Z http://t.co/VoYrUxcrIN,16,['Failed'],1,1,0,15,natural disaster,0
More Natural Disaster Research Urgent http://t.co/5Cm0LfZhxn via #JakartaPost,11,['disaster'],1,1,0,10,disaster,0
its only getting colder and colder and faster and faster and when i first realized it it was like a natural disaster,22,"['getting', 'realized', 'was']",3,1,0,21,natural disaster,0
natural disaster ├½Ôûê├è News Stories About natural disaster - Page 1 | Newser http://t.co/TB8gZEMbXU,16,['natural disaster'],1,1,0,15,natural disaster,0
IRIN Asia | Red tape tangles Nepal reconstruction | Nepal | Disaster Risk Reduction | Natural Disasters http://t.co/q7LG6ncf7G,20,['tangles'],1,1,0,19,disaster,0
Expert Prepper: Financial Collapse Natural Disaster Failed Grid... http://t.co/5tf4CV4KeI http://t.co/KqYCFkcLr5,16,['Failed'],1,1,0,15,natural disaster,0
"This is the natural and unavoidable consequence of socialism everywhere it has been tried.
http://t.co/BbDpnj8XSx A",19,"['is', 'has', 'been', 'tried', '//t.co/BbDpnj8XSx']",5,1,0,18,natural disaster,0
Suncorp net profit rises to $1.13 billion in worst year of natural disaster claims http://t.co/cwZ37lNDVk,18,['rises'],1,1,0,17,natural disaster,0
Washi is indeed 'A Natural Disaster' ????,12,['is'],1,1,0,11,natural disaster,0
Of course the one day I have to dress professionally aka unsensibly for class is the day I have try and outrun a natural disaster!,26,"['have', 'dress', 'is', 'have', 'try', 'outrun']",6,1,0,25,natural disaster,0
We have overrun a Natural Disaster Survival server!,9,"['have', 'overrun']",2,1,0,8,natural disaster,0
Top insurer blasts lack of Australian Govt action on disaster mitigation http://t.co/sDgOUtWNtb via @smh,17,['disaster'],1,10,9,7,disaster,0
I added a video to a @YouTube playlist http://t.co/Ei5Z52tohR Natural Disaster Survival ep.7 '2079 Bacon Hair...',21,"['added', 'ep.7']",2,1,0,20,natural disaster,0
Savings and sewing in Guatemala: Savings and sewing in Guatemala. When a natural disaster hit seamstress Elvia...  http://t.co/jdx9OX2kIk,23,"['sewing', 'sewing', 'hit']",3,1,0,22,natural disaster,0
Patriot Survival Guide: Do you know how survive when the governments collapse or other natural disaster happens? http://t.co/QhtoerhDkM,22,"['Do', 'know']",2,1,0,21,natural disaster,0
RT Karnythia: Another #ErasureIsNotEquality example? Movies like The Impossible about a natural disaster in Thailand that focuses on white ├½Ôûê_,23,['focuses'],1,1,0,22,natural disaster,0
@jonk @jamucsb Hopefully this vacation *doesn't* include an earthquake or other natural disaster!,16,['include'],1,1,0,15,natural disaster,0
New 15-Day Emergency food supply for natural disaster Earthquake Flood Tornado http://t.co/6hrlBLiIcO http://t.co/WS0nVDUZqW,17,['natural disaster'],1,1,0,16,natural disaster,1
How You Can Help The Community In The Event Of A Natural Disaster - http://t.co/42LgdZXz62,17,['Help'],1,1,0,16,natural disaster,0
TRAIN ACCIDENT IN HARDA (M.P.) IS NOT NATURAL DISASTER. IT SHOWS FAILURE OF MINISTRY OF RAILWAY.PROPER CHECK AT FIXED INTERVAL IS NEEDED.,27,['IS'],1,1,0,26,natural disaster,1
This was amazing. Probably couldn't have watched if still living in Japan. Scary. Nuclear Meltdown Disaster | Nova http://t.co/j00WxMJRya,25,"['was', 'amazing', 'have', 'watched', 'living']",5,1,0,24,nuclear disaster,0
Chronicles of #disaster:#Hiroshima in the #Yale Library #archives http://t.co/xqIqGMI0Op  Calls to end 'absolute evil' of #nuclear #weapons,28,"['archives', 'Calls', 'end']",3,1,0,27,nuclear disaster,0
beforeitsnews : 3 former executives to be prosecuted in Fukushima nuclear disaster ├½Ôûê_ http://t.co/FgVN2vCrrX) http://t.co/kftVNU7nvf,20,"['be', 'prosecuted']",2,1,0,19,nuclear disaster,0
Alarming Rise in Dead Marine Life Since the #Fukushima Nuclear Disaster: http://t.co/v6H97K688J http://t.co/tJw9bSeiPW,19,['Alarming'],1,1,0,18,nuclear disaster,0
"No authorities of Japan take responsibility about Nuclear disaster.
Nobody have confidence in safety of Nuclear Plants in Japan.
#Anonymous├½Ôûê_",23,"['take', 'have']",2,1,0,22,nuclear disaster,0
If i tweet daily #Fukushima #Japan global nuclear disaster&amp; #Chernobyl ppl dont care there is no hope 4 humanity C&gt; http://t.co/MAcob5xLsU,32,"['tweet', 'is']",2,1,0,31,nuclear disaster,0
"?#FUKUSHIMA?#TEPCO?
Fukushima Nuclear Disaster | Increased Thyroid Cancer in #US - Integrative Cancer Answers
http://t.co/7Y2GNVA2eV",24,['Increased'],1,1,0,23,nuclear disaster,0
Though serious #natural #disaster increased in #Japanjapan #Nuclear safety standard is far inferior to #US standard.#anonymous #Nytimes,25,"['increased', 'is']",2,1,0,24,nuclear disaster,0
Physical sense helps preserve memories of 2011 triple disaster (8/4 AJW) http://t.co/X5jGKjV6Ma #jishin_e #nuclear #Minamisoma,22,"['helps', 'preserve']",2,1,0,21,nuclear disaster,0
"http://t.co/GaM7otGISw
ANOTHER DISASTER WAITING TO HAPPEN AND YOUR ALLOWING IT???",15,['nuclear disaster'],1,1,0,14,nuclear disaster,0
@DalaiLama then have the biggest nuclear disaster to ever have happened,12,"['have', 'have', 'happened']",3,1,0,11,nuclear disaster,0
Digital archive of public documents on the 2011 nuclear catastrophe at Fukushima launched. http://t.co/faJnMjNcxp,17,['launched'],1,1,0,16,nuclear disaster,0
Less consuming less energy to avoid nuclear disaster again and again.,12,"['consuming', 'avoid']",2,1,0,11,nuclear disaster,0
truthfrequencyradio Third of US West Coast Children Hit with Problems Following Fukushima NUCLEAR DISASTER: FU... http://t.co/7ktvkW3sS0,20,['Following'],1,1,0,19,nuclear disaster,0
#Obama signed up to a deal that far from making the world a safer place http://t.co/E0luGBL6pb via @upi #Iran #Nuclear #IranNuclearDeal,28,"['signed', 'making']",2,1,0,27,nuclear disaster,0
3 former executives to be prosecuted in Fukushima nuclear disaster http://t.co/zsDVWEgLF5,13,"['be', 'prosecuted']",2,1,0,12,nuclear disaster,0
http://t.co/kPbtBLRKsB Japan's Nuclear Disaster and it's ongoing side effects.,14,"[""'s""]",1,1,0,13,nuclear disaster,0
3 former executives to be prosecuted in Fukushima nuclear disaster http://t.co/uNTyEVXR4v,13,"['be', 'prosecuted']",2,1,0,12,nuclear disaster,0
@emmerdale can we have a public vote for the next annual village disaster?  i want an isis strike or a nuclear accident &amp; end this forever,30,"['have', 'want', 'end']",3,1,0,29,nuclear disaster,0
3 former executives to be prosecuted in Fukushima nuclear disaster http://t.co/Gvj7slbELP,13,"['be', 'prosecuted']",2,1,0,12,nuclear disaster,0
Fukushima Nuclear Disaster | Increased Thyroid Cancer in U.S. http://t.co/FtuNlH6ddg,12,['Increased'],1,1,0,11,nuclear disaster,0
The people who tweet and care about #Japan #Fukushima nuclear disaster are not the problem those who ignore are the problem.,24,"['tweet', 'care', 'are', 'ignore', 'are']",5,1,0,23,nuclear disaster,0
We want to see no more Hiroshima and Nagasaki nuclear bomb disaster in this beautiful world.Lets be peaceful &amp; save this human civilization.,26,"['want', 'see', 'be', 'save']",4,1,0,25,nuclear disaster,0
Check out 'NOVA | Nuclear Meltdown Disaster' http://t.co/ZzxM74d7qV #PBS,13,['Check'],1,1,0,12,nuclear disaster,0
#Japan #Fukushima the most serious man made disaster in human history...  ├½Ôûê┬ña marker of radiation brain damage├½Ôûê├ÿ http://t.co/Y3ZfqJsvpz,23,['made'],1,1,0,22,nuclear disaster,0
Rare photographs show the nightmare aftermath of #Hiroshima | #NoNukes #Amerikkka #WhiteTerrorism #Nuclear #Disaster  http://t.co/8tWLAKdaBf,23,['show'],1,1,0,22,nuclear disaster,0
#refugees of #nuclear disaster in western #Japan will be beyond 500 thousand at least. #AFP #guardian #WPS #NYTimes,26,['be'],1,1,0,25,nuclear disaster,0
3 former executives to be prosecuted in Fukushima nuclear disaster http://t.co/EmWU8Xksdu,13,"['be', 'prosecuted']",2,1,0,12,nuclear disaster,0
3 Former Executives To Be Prosecuted In Fukushima Nuclear Disaster http://t.co/UmjpRRwRUU,13,"['Be', 'Prosecuted']",2,1,0,12,nuclear disaster,0
Fukushima Watch - Fukushima Watch Nuclear Disaster: Welcome. Welcome To Fukushima Watch offering t... http://t.co/M0KJdlwKFB #fukushima,22,['nuclear disaster'],1,1,0,21,nuclear disaster,0
CLOSING THEIR EYES TO DISASTER!  State Department Unaware of Reports Iran is Sanitizing Nuclear Sites http://t.co/yRVGyKdbM6,19,"['is', 'Sanitizing']",2,1,0,18,nuclear disaster,0
"3 Former Executives to Be Prosecuted in Fukushima Nuclear #Disaster.

The story: http://t.co/7uFnxxaVqs via @nytimes",21,"['Be', 'Prosecuted']",2,1,0,20,nuclear disaster,0
30 Years After the Chernobyl Nuclear Disaster via @fubiz http://t.co/N4B59iqm94,13,['nuclear disaster'],1,1,0,12,nuclear disaster,0
Any disaster impairs mental health especially in vulnerable individuals... http://t.co/ZisuwLqRHf,13,['nuclear disaster'],1,1,0,12,nuclear disaster,0
Fukushima 'mutant vegetable' images sweep across the region two years after nuclear disaster http://t.co/psi35AU3pc via @MailOnline,20,['sweep'],1,1,0,19,nuclear disaster,0
"Safety by #Nuclear regulatory committee of Japan is already weakened by Authoritarian that caused Nuclear disaster
@nytimes @guardian @WDR",23,"['is', 'weakened', 'caused']",3,1,0,22,nuclear disaster,0
Bombing #Iran would result in a never-ending game of #nuclear whack-a-mole. Here's why: http://t.co/6exS23MUy3 http://t.co/l9iDheROtj,24,"['Bombing', 'result', ""'s""]",3,1,0,23,nuclear disaster,0
The people who tweet and care about #Japan #Fukushima nuclear disaster are not the problem those who ignore are the problem.,24,"['tweet', 'care', 'are', 'ignore', 'are']",5,1,0,23,nuclear disaster,0
Fukushima: The Story of a Nuclear Disaster http://t.co/ikpnGs3dTi http://t.co/lJHgSdRAEZ,14,['nuclear disaster'],1,1,0,13,nuclear disaster,0
The president spoke of Kennedy's diplomacy to avert nuclear disaster during the Cold War to bolster his own pitch for Congress' approval,24,"['spoke', 'avert', 'bolster']",3,1,0,23,nuclear disaster,0
573 deaths have been certified by the Government as ├½Ôûê┬©nuclear disaster-related deaths├½Ôûê┬¼,12,"['have', 'been', 'certified']",3,1,0,11,nuclear disaster,1
3 Former Executives to Be Prosecuted in Fukushima Nuclear Disaster http://t.co/JSsmMLNaQ7,13,"['Be', 'Prosecuted']",2,1,0,12,nuclear disaster,0
70 years ago today 1945 #Hiroshima was the first nuclear atomic bomb leaving a major disaster in the wake. http://t.co/oW4GeXyNbH,24,"['was', 'leaving']",2,1,0,23,nuclear disaster,0
If U care about life on land sea &amp; in air then dont pretend &amp; ignore the nuclear disaster in #Japan #Fukushima this is a #global problem,34,"['dont', 'ignore', 'is']",3,1,0,33,nuclear disaster,0
"#Nuclear policy of #Japan without responsibility about Nuclear #Disaster will repeat same #failure.
#annonymous #guardian #NYTimes #Reuters",26,['repeat'],1,1,0,25,nuclear disaster,0
Chernobyl disaster - Wikipedia the free encyclopedia don't you just love the nuclear technology it's so glorious  https://t.co/GHucazjSxB,22,"['do', 'love', ""'s""]",3,1,0,21,nuclear disaster,0
Nuclear-Deal: Indo-Japan pact lies at the heart of two US reactor-based projects: If Japan were to go ahead an... http://t.co/mvwdm9ZbcV,25,"['lies', 'were', 'go']",3,1,0,24,nuclear reactor,0
Global Nuclear Reactor Construction Market grew 4.5% between 2013 and 2014 http://t.co/74JppeK6o7,15,['grew'],1,1,0,14,nuclear reactor,0
Salem 2 nuclear reactor shut down over electrical circuit failure on pump: The Salem 2 nuclear reactor had bee... http://t.co/5hkGXzJLmX,24,"['shut', 'had']",2,1,0,23,nuclear reactor,0
US Navy Sidelines 3 Newest Subs - http://t.co/guvTIzyCHE: DefenseNews.comUS Navy Sidelines 3 Newest SubsD... http://t.co/SY2WhXT0K5 #navy,23,['nuclear reactor'],1,1,0,22,nuclear reactor,0
@MaximEristavi Meanwhile in Finland: Nuclear project with Russian Rosatom moves on http://t.co/ogkoeFvzrj,16,['nuclear reactor'],1,1,0,15,nuclear reactor,0
@RobertHarding @RepJohnKatko Crazy to use the Netanyahu argument Iran can flush A NUCLEAR REACTOR DOWN THE TOILET,19,"['RobertHarding', 'use', 'flush']",3,1,0,18,nuclear reactor,0
Nuclear-Deal: Indo-Japan pact lies at the heart of two US reactor-based projects: If Japan were to go ahead an...  http://t.co/XKURDr3yEv,25,"['lies', 'were', 'go']",3,1,0,24,nuclear reactor,0
Nuclear #Solar Power #Japanese #Fukushima Reactor Energy Japan Temperature No. Fuel Pool More  http://t.co/YS3nMwWyVc http://t.co/AlpotNB7q3,23,['nuclear reactor'],1,1,0,22,nuclear reactor,0
Japan's Restart of Nuclear Reactor Fleet Fast Approaches http://t.co/DbAUjp29Ub,12,['nuclear reactor'],1,1,0,11,nuclear reactor,0
If I'm also not mistaken we're sitting right next 2 a nuclear reactor. Not smart when we have a cataclysmic event &amp; that reator melts down.,32,"[""'m"", 'mistaken', ""'re"", 'sitting', 'have', 'melts']",6,1,0,31,nuclear reactor,0
ThorCon: A Thorium Molten Salt Reactor System that can be built Now https://t.co/K90M1qoE9q #thorium #Auspol #climate #nuclearrcSA #nuclear,26,"['be', 'built', 'https']",3,1,0,25,nuclear reactor,0
@stunckle @Gordon_R74 @crazydoctorlady ...I'm no expert but raw uranium and nuclear reactor fuel rods are 2 very different creatures...,25,"[""'m"", 'are']",2,1,0,24,nuclear reactor,0
Rolling sandunes the gentle lapping of the sea the call of gulls and a nuclear reactor #sizewell http://t.co/X9CUiHIb5n,21,['Rolling'],1,1,0,20,nuclear reactor,0
Salem 2 nuclear reactor shut down over electrical circuit failure on pump http://t.co/LQjjy1PTWT,15,['shut'],1,1,0,14,nuclear reactor,0
Finnish ministers: Fennovoima nuclear reactor will go ahead http://t.co/vB3VFm76ke #worldnews #news #breakingnews,18,['go'],1,1,0,17,nuclear reactor,0
Salem 2 nuclear reactor shut down over electrical circuit failure on pump - http://t.co/98o2Kc3A1Z http://t.co/tGdontTkty,19,['shut'],1,1,0,18,nuclear reactor,0
@AlbertBrooks Don't like the Ayatollah Khomeini Memorial Nuclear Reactor for the Annihilation of Israel? Racist!,19,"['Do', 'like']",2,1,0,18,nuclear reactor,0
@SnowyWolf5 @TheGreenParty Besides would you rather shut down a whole nuclear reactor for maintenance or a wind turbine at a time?,24,['shut'],1,1,0,23,nuclear reactor,0
Whereas Jez will obliterate the national debt - and give lots of new benefits - by simply printing money! Genius! https://t.co/ReffbkVG9R,25,"['obliterate', 'give', 'printing']",3,4,3,21,obliterate,0
@McCaineNL Think how spectacular it will look when the Stonewall riots obliterate the white house.,17,"['look', 'obliterate']",2,13,12,4,obliterate,0
Watch Sarah Palin OBLITERATE Planned Parenthood For Targeting Minority Women! ├½Ôûê├è BB4SP http://t.co/Dm0uUpqGWY,16,['Planned'],1,1,0,15,obliterate,0
@PauloSergioMDC @TheIranDeal @POTUS Those silly talks trusting a terrorist nation (who hates us) that has vowed to obliterate Israel.,25,"['trusting', 'hates', 'has', 'vowed', 'obliterate']",5,23,22,2,obliterate,0
@lionofjudah1948 @AmericanJewry The Nazis pursued their ambitions to obliterate a religion in Europe #Israel is trying to do the same,23,"['pursued', 'obliterate', 'is', 'trying', 'do']",5,11,10,12,obliterate,0
Someone teaching you that obedience will obliterate trials in your life is trying to sell you a used car. Jesus's life blows that theory.',28,"['teaching', 'obliterate', 'is', 'trying', 'sell', 'blows']",6,7,6,21,obliterate,0
@Wadeycakes @ThunderCastTV you're right Thunder would obliterate you #HEYOOO,13,"[""'re"", 'obliterate']",2,10,9,3,obliterate,0
@breakingnewslh @bree_mars watch cnn's the seventies terrorism episode. Iran has always hated the U.S. They want us obliterated.,24,"['bree_mars', 'watch', 'has', 'hated', 'want', 'obliterated']",6,23,22,1,obliterated,0
@dinnerwithjulie because its been obliterated?,7,"['been', 'obliterated']",2,6,5,1,obliterated,0
Drunk Meals 101: What To Cook When You're Totally Obliterated http://t.co/m19iVWrdkk,15,"['Cook', ""'re""]",2,1,0,14,obliterated,0
WACKOS like #MicheleBachman predict the WORLD will SOON be OBLITERATED by a burning firey INFERNO but cant accept #GlobalWarming!! HELLO!!!,27,"['predict', 'be', 'OBLITERATED', 'GlobalWarming']",4,1,0,26,obliterated,0
@LeonC1963 @RomanGaul @Makrina91 Never realised how many conventional bombs the Yanks dropped on Japan prior 2 Nuks. They obliterated cities,24,"['realised', 'dropped', 'obliterated']",3,23,22,1,obliterated,0
Remembering #Hiroshima 70 years on. Hundreds of thousands of lives obliterated 70 years of pain devastating... http://t.co/cZpJVJgXRp,22,"['Remembering', 'obliterated']",2,13,12,9,obliterated,0
@TheEvilOlives It's the closest structure to the hypo centre that wasn't completely obliterated.,17,"['TheEvilOlives', ""'s"", 'was', 'obliterated']",4,16,15,1,obliterated,0
The day Hiroshima through the eyes of the bomber crew and survivors http://t.co/AYEWJ8marn via @MailOnline,18,['http'],1,1,0,17,obliterated,0
Kontrolled Media say 'US good. Putin bad. #WW3 good Peace bad'. TOTAL BS! Leave Russia alone. DON'T DICE WITH OBLITERATION. #demonization,31,"['Kontrolled', 'say', 'DO']",3,1,0,30,obliteration,0
@ThatSabineGirl you get me sis. this planet could do with a huge dose of obliteration.,18,"['get', 'do']",2,17,16,1,obliteration,0
@tiggr_ why only Squad Obliteration?,7,['obliteration'],1,1,0,6,obliteration,0
[Chaos dancing in the streets | Why did God order obliteration of ancient Canaanites?] http://t.co/P7DLX1wFmC via @Michael_0000,23,"['|', 'did']",2,12,11,11,obliteration,0
@KDonhoops Sure! Meek Mill accused Drake of not writing his own raps. Drake responds w/ obliteration of Meek's career. #OldFolkExplainStuff,26,"['accused', 'writing', 'responds']",3,19,18,7,obliteration,0
Here we are 70 years after the nuclear obliteration of Hiroshima and Nagasaki and I├½Ôûê┬¼m wondering i├½Ôûê_ http://t.co/fvkekft4Rs,20,"['are', 'wondering']",2,9,8,11,obliteration,0
"Path of Obliteration
Back From The Dead
Story by @KyleWappler @thisishavehope

 http://t.co/1PdNlsP8XW",16,['obliteration'],1,1,0,15,obliteration,0
Refugio oil spill may have been costlier bigger than projected: A Plains All American Pipeline├½Ôûê_ http://t.co/sryaFqj9gZ #globetrottingwino,21,"['have', 'been', 'projected']",3,1,0,20,oil spill,1
SB57 [NEW] Deepwater Horizon Oil Spill distribution of funds from BP settlement road and bridge projects in Bal... http://t.co/dKpsrkG6pc,24,['oil spill'],1,1,0,23,oil spill,0
California oil spill might be larger than projected: http://t.co/xwxBYHTuzC http://t.co/wzeDxEFBlg,15,"['be', 'projected']",2,1,0,14,oil spill,0
Refugio oil spill may have been costlier bigger than projected: A Plains All American Pipeline oil spill off ... http://t.co/yhmrEgAuxZ,23,"['have', 'been', 'projected']",3,1,0,22,oil spill,0
Refugio oil spill may have been costlier bigger than projected - http://t.co/6aUOT9vaIS  http://t.co/j2SyewbHE2,17,"['have', 'been', 'projected']",3,1,0,16,oil spill,0
#breaking #LA Refugio oil spill may have been costlier bigger than projected http://t.co/5ueCmcv2Pk,17,"['breaking', 'have', 'been', 'projected']",4,1,0,16,oil spill,1
LA Times: Refugio oil spill may have been costlier bigger than projected http://t.co/g37huJx6et,16,"['have', 'been', 'projected']",3,1,0,15,oil spill,0
'California: Spring Oil Spill Estimate Grows ' by THE ASSOCIATED PRESS via NYT http://t.co/6Cx46E7QB7,17,['oil spill'],1,1,0,16,oil spill,0
Refugio oil spill may have been costlier bigger than projected http://t.co/41L8tqCAey,13,"['have', 'been', 'projected']",3,1,0,12,oil spill,0
Refugio oil spill may have been costlier bigger than projected http://t.co/Rqu5Ub8PLF,13,"['have', 'been', 'projected']",3,1,0,12,oil spill,0
Refugio oil spill may have been costlier bigger than projected http://t.co/OSJUrFDDkt,13,"['have', 'been', 'projected']",3,1,0,12,oil spill,0
National Briefing | West: California: Spring Oil Spill Estimate Grows: Documents released on Wednesday disclos... http://t.co/PsYWDxCCmj,22,['released'],1,1,0,21,oil spill,0
Refugio oil spill may have been costlier bigger than projected http://t.co/lzob8qOH1B,13,"['have', 'been', 'projected']",3,1,0,12,oil spill,0
PODCAST: Oil spill anniversary http://t.co/wVdAVXTDaq,8,['oil spill'],1,1,0,7,oil spill,0
Refugio oil spill may have been costlier bigger than projected http://t.co/BIEYgUqpB1,13,"['have', 'been', 'projected']",3,1,0,12,oil spill,0
'California: Spring Oil Spill Estimate Grows ' by THE ASSOCIATED PRESS via NYT http://t.co/gPKkHhBRIy,17,['oil spill'],1,1,0,16,oil spill,0
Sydney Traffic HAZARD Oil spill - BANKSTOWN Stacey St at Wattle St #sydtraffic #trafficnetwork,16,['oil spill'],1,1,0,15,oil spill,0
Plains All American Pipeline company may have spilled 40% more crude oil than previously estimated #KSBYNews @lilitan http://t.co/PegibIqk2w,23,"['have', 'spilled', 'estimated']",3,1,0,22,oil spill,0
SYD traffic HAZARD Oil spill - BANKSTOWN Stacey St at Wattle St http://t.co/TZyHdBW9f5,15,['oil spill'],1,1,0,14,oil spill,0
"Watch our video of Wendell Berry speaking about the BP oil spill in the Gulf of Mexico.

It├½Ôûê┬¼s the birthday... http://t.co/tN1aX1xMBB",25,"['Watch', 'speaking']",2,1,0,24,oil spill,0
Refugio oil spill may have been costlier bigger than projected: A Plains All American Pipeline oil spill... http://t.co/lCQFI3LMAf #MLB,24,"['have', 'been', 'projected']",3,1,0,23,oil spill,0
National Briefing | West: California: Spring Oil Spill Estimate Grows: Documents released on Wednesday disclos... http://t.co/wBi7Laq18E,22,['released'],1,1,0,21,oil spill,0
DTN Brazil: Refugio oil spill may have been costlier bigger than projected: A Plains All American Pipeline oi... http://t.co/pDOSrg8Cf7,24,"['have', 'been', 'projected']",3,1,0,23,oil spill,0
Hannah: 'Hiroshima sounds like it could be a place in China. Isn't that where the oil spill was?',23,"['be', 'Is', 'was']",3,1,0,22,oil spill,0
Refugio oil spill may have been costlier bigger than projected http://t.co/aP30psZkVx,13,"['have', 'been', 'projected']",3,1,0,12,oil spill,0
Refugio oil spill may have been costlier bigger than projected (LA Times) http://t.co/TCSoLvwhXq,17,"['have', 'been', 'projected']",3,1,0,16,oil spill,0
California: Spring Oil Spill Estimate Grows: Documents released on Wednesday disclosed that an oil sp... http://t.co/zqiHnHDWPV #OSI2016,23,"['released', 'disclosed']",2,1,0,22,oil spill,0
Refugio oil spill may have been costlier bigger than projected http://t.co/gtHddzAvhg #LosAngelesTimes #latimes #news,19,"['have', 'been', 'projected']",3,1,0,18,oil spill,0
When the Government couldn't figure out how to plug the Gulf oil spill so Chuck Norris plugged it...with his fist.,24,"['figure', 'plug', 'plugged']",3,1,0,23,oil spill,0
National Briefing | West: California: Spring Oil Spill Estimate Grows: Documents released on Wednesday d... http://t.co/hTxAi05y7B (NYT),25,['released'],1,1,0,24,oil spill,0
Plains All American Pipeline company may have spilled 40 percent more crude oil than previously estimated.... http://t.co/WEZjqC4Cf2,21,"['have', 'spilled', 'estimated']",3,1,0,20,oil spill,0
@Kinder_Morgan can'twon't tell @cityofkamloops how they'd respond to an oil spill. Trust them? See Sec 4.2 #Kamloops http://t.co/TA6N9sZyfP,27,"[""can'two"", 'tell', 'cityofkamloops', 'respond', 'See']",5,1,0,26,oil spill,0
news@@ Refugio oil spill may have been costlier bigger than projected http://t.co/jhpdSSVhvE,16,"['have', 'been', 'projected']",3,1,0,15,oil spill,0
Plains: Calif. Oil Spill Could be Larger than Estimated. http://t.co/CcvcTe3lCw,14,"['be', 'Estimated']",2,1,0,13,oil spill,0
Refugio oil spill may have been costlier bigger than projected http://t.co/xcoLwUGFjg,13,"['have', 'been', 'projected']",3,1,0,12,oil spill,0
Refugio oil spill may have been costlier bigger than projected http://t.co/FPaouLWU3N,13,"['have', 'been', 'projected']",3,1,0,12,oil spill,0
@News@ Refugio oil spill may have been costlier bigger than projected http://t.co/SqoA1Wv4Um,16,"['have', 'been', 'projected']",3,1,0,15,oil spill,0
Refugio oil spill may have been costlier bigger than projected http://t.co/GusrAmzp1s #news,15,"['have', 'been', 'projected']",3,1,0,14,oil spill,0
Refugio oil spill may have been costlier bigger than projected http://t.co/7L6bHeXIXv | https://t.co/eMOSrMUvQa,17,"['have', 'been', 'projected']",3,1,0,16,oil spill,0
News@ Refugio oil spill may have been costlier bigger than projected http://t.co/jhpdSSVhvE,15,"['have', 'been', 'projected']",3,1,0,14,oil spill,0
Refugio oil spill may have been costlier bigger than projected http://t.co/EFCn9IVNfg A Plains All American Pipeline oil spill off the S├½Ôûê_,23,"['have', 'been', 'projected', '//t.co/EFCn9IVNfg']",4,1,0,22,oil spill,0
"NSW - BANKSTOWN Stacey St at Wattle St
HAZARD Oil spill
Started today 11:38am last checked today 11:54am
Impact:... http://t.co/5ze5Z6BjLi",24,"['Started', 'checked']",2,1,0,23,oil spill,0
Refugio oil spill may have been costlier bigger than projected http://t.co/d7FdCLU404,13,"['have', 'been', 'projected']",3,1,0,12,oil spill,0
Refugio oil spill may have been costlier bigger than projected http://t.co/zdtcw9Fsx1,13,"['have', 'been', 'projected']",3,1,0,12,oil spill,0
'California: Spring Oil Spill Estimate Grows ' by THE ASSOCIATED PRESS via NYT http://t.co/kUiecEtK2z,17,['oil spill'],1,1,0,16,oil spill,0
LA Times: Refugio oil spill may have been costlier bigger than projected http://t.co/1ct0pUGZ69,16,"['have', 'been', 'projected']",3,1,0,15,oil spill,0
Senator voices concerns over BP oil spill settlement http://t.co/mFSBWpj0Ce,11,['oil spill'],1,1,0,10,oil spill,0
'California: Spring Oil Spill Estimate Grows ' by THE ASSOCIATED PRESS via NYT http://t.co/zdpa4DBtsU,17,['oil spill'],1,1,0,16,oil spill,0
Families to sue over Legionnaires: More than 40 families affected by the fatal outbreak of Legionnaires' disea... http://t.co/02ELqLOpFk,23,"['sue', 'affected']",2,15,14,8,outbreak,1
Families to sue over Legionnaires - More than 40 families affected by the fatal outbreak of Legionnaires' disease ... http://t.co/urbl692Syj,23,"['sue', 'affected']",2,15,14,8,outbreak,1
Families to sue over Legionnaires: More than 40 families affected by the fatal outbreak of Legionnaires' disease in Edinburgh are to ...,24,"['sue', 'affected', 'are']",3,15,14,9,outbreak,1
Families to sue over Legionnaires: More than 40 families affected by the fatal outbreak of Legionnaires' disea... http://t.co/8lCbDW7m2z,23,"['sue', 'affected']",2,15,14,8,outbreak,1
Families to sue over Legionnaires: More than 40 families affected by the fatal outbreak of Legionnaires' disea... http://t.co/yfsD4xS7lc,23,"['sue', 'affected']",2,15,14,8,outbreak,1
Legionnaires' Disease: What's Being Done to Stop Deadly Outbreak http://t.co/AjzY19Vepu,15,"[""'s"", 'Being', 'Stop']",3,1,0,14,outbreak,1
10th death confirmed in Legionnaires' outbreak in South Bronx; total cases reaches triple digits http://t.co/JtzefipdBo,19,"['confirmed', 'reaches']",2,7,6,12,outbreak,0
More than 40 families affected by the fatal outbreak of Legionnaires' disease in Edinburgh are to sue two comp... http://t.co/vsoXioOy78,24,"['affected', 'are', 'sue']",3,9,8,15,outbreak,1
A Mad Catastrophe : The Outbreak of World War I and the Collapse of the... http://t.co/jGdlX4Faw8 http://t.co/IvwtYnoUjK,22,['outbreak'],1,1,0,21,outbreak,0
Families to sue over Legionnaires: More than 40 families affected by the fatal outbreak of Legionnaires' disea... http://t.co/2Mwc9YWjZy,23,"['sue', 'affected']",2,15,14,8,outbreak,1
Wow-the name #LegionnairesDisease comes from an outbreak of pneumonia at the @AmericanLegion convention in Philly in 1976--29 died from it.,25,"['comes', 'died']",2,8,7,17,outbreak,0
'Legionnaires' Disease: What's Being Done to Stop Deadly Outbreak' http://t.co/FftOKd0Vts #????_?????,27,"[""'s"", 'Being', 'Stop', '_']",4,1,0,26,outbreak,0
Families to sue over Legionnaires: More than 40 families affected by the fatal outbreak of Legionnaires' disea... http://t.co/81HVV3N3rS,23,"['sue', 'affected']",2,15,14,8,outbreak,1
Families to sue over Legionnaires: More than 40 families affected by the fatal outbreak of Legionnaires' disea... http://t.co/2AO97o2a9D,23,"['sue', 'affected']",2,15,14,8,outbreak,1
Families to sue over Legionnaires: More than 40 families affected by the fatal outbreak of Legionnaires' disease in Edinburgh are to ...,24,"['sue', 'affected', 'are']",3,15,14,9,outbreak,1
Families to sue over Legionnaires: More than 40 families affected by the fatal outbreak of Legionnaires' disea... http://t.co/3sNyOOhseq,23,"['sue', 'affected']",2,15,14,8,outbreak,1
Families to sue over Legionnaires: More than 40 families affected by the fatal outbreak of Legionnaires' disea... http://t.co/VBsj8tniv1,23,"['sue', 'affected']",2,15,14,8,outbreak,1
Families to sue over Legionnaires: More than 40 families affected by the fatal outbreak of Legionnaires' disea... http://t.co/z16jNX3LQe,23,"['sue', 'affected']",2,15,14,8,outbreak,1
Families to sue over Legionnaires: More than 40 families affected by the fatal outbreak of Legionnaires' disea... http://t.co/SO81Ab3a1x,23,"['sue', 'affected']",2,15,14,8,outbreak,1
Legionnaires' Disease: What's Being Done to Stop Deadly Outbreak http://t.co/Ud96b7ThsV,15,"[""'s"", 'Being', 'Stop']",3,1,0,14,outbreak,1
Families to sue over Legionnaires: More than 40 families affected by the fatal outbreak of Legio... http://t.co/uCBfgIBFOR #MuhamadJabal,23,"['sue', 'affected']",2,15,14,8,outbreak,1
DTN Italy: Families to sue over Legionnaires: More than 40 families affected by the fatal outbreak of Legionna... http://t.co/RsV9ATj9vH,24,"['sue', 'affected']",2,18,17,6,outbreak,1
Mumps outbreak at University of Illinois grows http://t.co/7xYkuJylX0 #SEBEE,12,['grows'],1,2,1,10,outbreak,0
@SenateMajLdr let's try to do our best to prevent another outbreak of violence by talking to each other both the people and the politics,26,"['do', 'prevent', 'talking']",3,13,12,13,outbreak,1
Families to sue over Legionnaires: More than 40 families affected by the fatal outbreak of Legionnaires' disea... http://t.co/oJyW7jkUH5,23,"['sue', 'affected']",2,15,14,8,outbreak,1
Families to sue over Legionnaires: More than 40 families affected by the fatal outbreak of Legionnaires' disea... http://t.co/rv9Dv6JOeW,23,"['sue', 'affected']",2,15,14,8,outbreak,1
New York City Outbreak: What Is Legionnaire's Disease?   http://t.co/CXI82rFiFS,14,['Is'],1,1,0,13,outbreak,0
Families to sue over Legionnaires: More than 40 families affected by the fatal outbreak of Legionnaires' disea... http://t.co/A6xRnI8XHg,23,"['sue', 'affected']",2,15,14,8,outbreak,1
Families to sue over Legionnaires: More than 40 families affected by the fatal outbreak of Legionnaires' disea... http://t.co/1H7zk6UYze,23,"['sue', 'affected']",2,15,14,8,outbreak,1
Families to sue over Legionnaires: More than 40 families affected by the fatal outbreak of Legionnaires' disea... http://t.co/RJEN6iMWPI,23,"['sue', 'affected']",2,15,14,8,outbreak,1
Families to sue over Legionnaires: More than 40 families affected by the fatal outbreak of Legionnaires' disea... http://t.co/boZfh1M3wb,23,"['sue', 'affected']",2,15,14,8,outbreak,1
Families to sue over Legionnaires: More than 40 families affected by the fatal outbreak of Legionnaires' disea... http://t.co/mNsy1QR7bq,23,"['sue', 'affected']",2,15,14,8,outbreak,1
Families to sue over Legionnaires: More than 40 families affected by the fatal outbreak of Legionnaires' disea... http://t.co/kkdX8zMV4G,23,"['sue', 'affected']",2,15,14,8,outbreak,1
Families to sue over Legionnaires: More than 40 families affected by the fatal outbreak of Legionnaires' disea... http://t.co/13W8CyukKZ,23,"['sue', 'affected']",2,15,14,8,outbreak,1
Families to sue over Legionnaires: More than 40 families affected by the fatal outbreak of Legionnaires' disea... http://t.co/hKxYzhvmQE,23,"['sue', 'affected']",2,15,14,8,outbreak,1
8th person dies in NY Legionnaires' disease outbreak http://t.co/fJdM8QHYAI #SEBEE,14,['outbreak'],1,9,8,5,outbreak,0
Legionnaires' Disease: What's Being Done to Stop Deadly Outbreak: The worst-ever outbreak of Legio... http://t.co/0ubG9wFyge #losangeles,24,"[""'s"", 'Being', 'Stop']",3,16,15,8,outbreak,0
Families to sue over Legionnaires: More than 40 families affected by the fatal outbreak of Legionnaires' disea... http://t.co/ZA4AXFJSVB,23,"['sue', 'affected']",2,15,14,8,outbreak,1
Families to sue over Legionnaires' disease outbreak in Edinburgh - BBC News http://t.co/rM6CNzkSzL,16,['sue'],1,8,7,8,outbreak,1
#News Families to sue over Legionnaires: More than 40 families affected by the fatal outbreak of Legionnaires'... http://t.co/zfYqSAwvrk,24,"['sue', 'affected']",2,17,16,7,outbreak,1
Families to sue over Legionnaires: More than 40 families affected by the fatal outbreak of Legionnaires' disea... http://t.co/6oPYSf87K2,23,"['sue', 'affected']",2,15,14,8,outbreak,1
Families to sue over Legionnaires: More than 40 families affected by the fatal outbreak o... http://t.co/3hTJ2PypSg #News #check #follow,26,"['sue', 'affected', 'follow']",3,15,14,11,outbreak,1
Families to sue over Legionnaires: More than 40 families affected by the fatal outbreak of Legionnaires' disea... http://t.co/NQ77EfMF88,23,"['sue', 'affected']",2,15,14,8,outbreak,1
Families to sue over Legionnaires: More than 40 families affected by the fatal outbreak of Legionnaires' disea... http://t.co/lfbdhTGQWG,23,"['sue', 'affected']",2,15,14,8,outbreak,1
An outbreak of Legionnaires' disease in New York has killed at least 8 people ├½Ôûê├ï now officials think they've fo... http://t.co/7evyeLW4LC,26,"['has', 'killed', 'think', ""'ve""]",4,2,1,24,outbreak,1
Families to sue over Legionnaires: More than 40 families affected by the fatal outbreak of Legionnaires' disea... http://t.co/Paje5mxN1z,23,"['sue', 'affected']",2,15,14,8,outbreak,1
More than 40 families affected by the fatal outbreak of Legionnaires' disease in Edinburgh are├½Ôûê_ http://t.co/XpvKqME5Ls,19,['affected'],1,9,8,10,outbreak,1
An outbreak of Legionnaires' disease in New York has killed at least 8 people @BI_Video http://t.co/eRJ7YANjXm http://t.co/vbRPeuJANL,23,"['has', 'killed']",2,2,1,21,outbreak,1
"#BREAKING 10th death confirmed in Legionnaires' outbreak in South Bronx; total cases reaches triple digits
http://t.co/TxrsWi0efg",21,"['confirmed', 'reaches']",2,9,8,12,outbreak,1
Pandemonium In Aba As Woman Delivers Baby Without Face (Photos).... http://t.co/lYXNjlxL8s http://t.co/CXYFqN3ue4,20,['pandemonium'],1,1,0,19,pandemonium,0
Pandemonium In Aba As Woman Delivers Baby Without Face (Photos) - http://t.co/c5u9qshhnb,16,['pandemonium'],1,1,0,15,pandemonium,0
I'll be at SFA very soon....#Pandemonium http://t.co/RW8b50xz9m,14,['be'],1,1,0,13,pandemonium,0
Pandemonium use to be my fav cd ?? I had to get it http://t.co/6WhUgaeM3C,17,"['be', 'had', 'get']",3,1,0,16,pandemonium,0
Pandemonium In Aba As Woman Delivers Baby Without Face (Photos) - http://t.co/xRP0rTkFfJ,16,['pandemonium'],1,1,0,15,pandemonium,0
@KhalidKKazi mate they've taken another 2 since I posted this tweet it's pandemonium,16,"[""'ve"", 'taken', 'posted', ""'s""]",4,16,15,0,pandemonium,0
I'll be at SFA very soon....#Pandemonium http://t.co/LC1cMx1mPb,14,['be'],1,1,0,13,pandemonium,0
The move Saturday --&gt; #Mirage! 400 N. West st. Raleigh NC 21+ http://t.co/bXdaTWjNHS Tickets at: http://t.co/7hAnPcr5rK,26,['pandemonium'],1,1,0,25,pandemonium,0
Pandemonium In Aba As Woman Delivers Baby Without Face (Photos): According to eye witnesses in Ogbor Hill in A... http://t.co/lJYIG8RBOQ,26,['According'],1,1,0,25,pandemonium,0
Pandemonium In Aba As Woman Delivers Baby Without Face├òÔò®(Photos) http://t.co/bM0SXzbNKE,15,['pandemonium'],1,1,0,14,pandemonium,0
Truly a scene of chaos unprecedented in frenzy. Pandemonium even. Utter disorder. That anyone survived such mania is astounding. @catovitch,25,"['unprecedented', 'survived', 'is', 'astounding']",4,1,0,24,pandemonium,0
"Tried 2 4get
Feelings of death
Invading panic spawns
Can't concentrate
No 1 relates
Stealing all the light
Spreading thin a soul in sections",25,"['Tried', 'Ca', 'concentrate', 'Stealing', 'thin']",5,8,7,17,panic,0
@elielcruz just watching the streams was bad - I don't think I could actually walk in there I'd panic and get sick,25,"['watching', 'was', 'do', 'think', 'walk', 'panic', 'get']",7,22,21,3,panic,0
"Panic over: Patient in Alabama tests negative for Ebola
http://t.co/cY0CiU2u1C",13,['negative'],1,1,0,12,panic,0
tomorrow's going to be a year since I went to the Panic! concert dressed as afycso ryan do u guys remember that,24,"['going', 'be', 'went', 'dressed', 'do', 'remember']",6,1,0,23,panic,0
@Dirk_NoMissSki yea but if someone faints why are they panicking?.. thats basic stuff ??,18,"['are', 'panicking']",2,11,10,7,panicking,0
I deserve a goddamn medal for dealing with this basement flood without panicking,13,"['deserve', 'dealing', 'panicking']",3,13,12,0,panicking,0
all that panicking made me tired ;__; i want to sleep in my bed,16,"['panicking', 'made', 'tired', 'want', 'sleep']",5,3,2,13,panicking,0
@milefromhome ??.. Don't.. I'm panicking..,9,"['@', ""'m""]",2,9,8,0,panicking,0
Police arrest suspect in killing of Mexican journalist and 4 women http://t.co/uvxLZhIG4R,14,['killing'],1,1,0,13,police,0
America said it had a war on terrorism. Then police took my AR-15 when I was ready to start shooting the enemies!,24,"['said', 'had', 'took', 'was', 'start', 'shooting']",6,11,10,13,police,0
Police: Gunman reported dead at Nashville area theater: A suspect who carried a gun and a hatchet at the Carmi... http://t.co/kqvN1uTpMM,26,"['reported', 'carried']",2,1,0,25,police,0
#BREAKING411 4 police officers arrested for abusing children at police-run boot camp in San Luis Obispo Calif. - ... http://t.co/oNLvf2fyoY,23,"['arrested', 'abusing']",2,11,10,12,police,0
#World #News Qld police wrap Billy Gordon investigation: QUEENSLAND Police have wrapped up their investigation...  http://t.co/msgnNDxOeK,22,"['wrap', 'have', 'wrapped']",3,6,5,16,police,0
'Gunman who opened fire at Tennessee movie theater killed by police'  Anyone suspect suicide-by-cop?,16,"['opened', 'killed']",2,11,10,5,police,0
Police kill hatchet-wielding gunman who opened fire inside Nashville movie theater: A├òÔò®middle-aged man├òÔò®armed wi... http://t.co/tyD47NfL5x,19,"['kill', 'opened', 'man├òÔò®armed']",3,1,0,18,police,0
A Santa Ana Police Union Blocks Video of the Raid at Sky High Holistic Pot Dispensary - The Atlantic http://t.co/yvV1RlghfT #SmartNews,24,['police'],1,1,0,23,police,0
4 police officers arrested for abusing children at police-run boot camp in San Luis Obispo Calif. - @ABC7: http://t.co/QpWOtugUI9,23,"['arrested', 'abusing']",2,9,8,14,police,0
Now Trending in Nigeria: Police charge traditional ruler others with informant├½Ôûê┬¼s  murder http://t.co/93inFxzhX0,16,"['Trending', 'charge']",2,1,0,15,police,0
California police officer pulls gun on man without any apparent provocation (VIDEO) http://t.co/Lhw4vTbHZG via @dailykos,20,['pulls'],1,2,1,18,police,0
FOLLOW-UP at 4700 BLOCK OF SW 11TH ST GRESHAM OR [Gresham Police #PG15000044153] 17:00 #pdx911,19,['police'],1,1,0,18,police,0
Oops: Bounty hunters try to raid Phoenix police chief's home: http://t.co/yPRJWMigHL -- A group of armed bounty... http://t.co/3RrKRCjYW7,26,"['try', 'raid']",2,9,8,17,police,0
$1 million bail for man accused of #shooting at Fife #police - Aug 5 @ 8:16 PM ET http://t.co/hu5CXqnoBf,24,"['accused', 'shooting']",2,14,13,10,police,0
DT @georgegalloway: RT @Galloway4Mayor: ├½Ôûê┬ñThe CoL police can catch a pickpocket in Liverpool Stree... http://t.co/vXIn1gOq4Q,22,['catch'],1,11,10,11,police,0
Police kill gunman at Nashville movie theatre - Times of India: Times of India Police kill├½Ôûê_ http://t.co/K8BExkgwr2,20,"['gunman', 'kill├½Ôûê_']",2,1,0,19,police,0
@robbiewilliams U fkn asswipe playing for Israeli child killers.. The fkn karma police will get U.,18,"['killers..', 'get']",2,14,13,4,police,0
Police: Tennessee theater shooting suspect was 29 http://t.co/CthoDZpLW3 #Philadelphia #News,15,"['shooting', 'was']",2,1,0,14,police,0
@ArizonaDOT Price Rd North bound closed from University to Rio Salado.. Lots of police..  What's crackin?,19,"['closed', ""'s""]",2,15,14,4,police,0
Selection September Bridgeport men charged in home invasion Police looking for burglar. - http://t.co/7mlCD0l0b8,17,"['charged', 'looking']",2,1,0,16,police,0
Police: Man killed ex grandmother after son wasn&amp;#8217;t named after him http://t.co/ndCy8Q7R6I OMG!!!!! Absolutely Crazy!!!,33,"['killed', 'named']",2,1,0,32,police,0
-=-0!!!!. Photo: LASTMA officials challenge police for driving against traffic in Lagos http://t.co/8VzsfTR1bG,21,"['challenge', 'driving']",2,12,11,9,police,0
Oops: Bounty hunters try to raid Phoenix police chief's home: A group of armed bounty hunters surrounded the h... http://t.co/dGELJ8rYt9,26,"['try', 'raid', 'surrounded']",3,9,8,17,police,1
ASSIST - CITIZEN OR AGENCY at NE LLOYD BLVD / NE OREGON ST [Portland Police #PP15000266835] 17:11 #pdx911,22,['police'],1,1,0,21,police,0
chickmt123: #letsFootball #atk WIRED : Reddit will now quarantine offensive content http://t.co/wvn6GrIyPq (http├½Ôûê_ http://t.co/pgIHchdURJ,22,['quarantine'],1,12,11,10,quarantine,0
Reddit Will Now Quarantine├½Ôûê_ http://t.co/pkUAMXw6pm #onlinecommunities #reddit #amageddon #freespeech #Business http://t.co/PAWvNJ4sAP,20,['quarantine'],1,1,0,19,quarantine,0
#Reddit updates #content #policy promises to quarantine ├½Ôûê┬©extremely offensive├½Ôûê┬¼ communities http://t.co/EHGtZhKAn4,16,"['updates', 'quarantine']",2,10,9,6,quarantine,0
Reddit Will Now Quarantine Offensive Content http://t.co/WosYPVQUFI http://t.co/XW8SDS1Tjp,12,['Quarantine'],1,1,0,11,quarantine,0
Reddit Will Now Quarantine Offensive Content &gt;&gt; http://t.co/WcIzstXk4f,15,['Quarantine'],1,1,0,14,quarantine,0
Reddit Will Now Quarantine Offensive├òÔò®Content http://t.co/VYgh2ni4Ah,8,['Quarantine'],1,1,0,7,quarantine,0
Reddit Will Now Quarantine Offensive Content http://t.co/KDc97PrQcc,9,['Quarantine'],1,1,0,8,quarantine,0
'Quarantine.' Enforced isolation to prevent contamination that could lead to disease or in some cases death.,19,"['prevent', 'lead', 'disease']",3,1,0,18,quarantine,0
Metal detectors protect public places from guns. Why not mental illness detectors to stop crazy shooters? And quarantine weirdos w/weapons..,22,"['protect', 'stop']",2,20,19,2,quarantine,0
Reddit Will Now Quarantine Offensive Content http://t.co/LTmgdP6Jaf,9,['Quarantine'],1,1,0,8,quarantine,0
Ebola Outbreak: Alabama Man Tested Negative For Virus 6 Firefighters 2 Family Members Quarantined - https://t.co/lCpR20USYL,19,['Quarantined'],1,1,0,18,quarantined,0
Officials: Alabama home quarantined over possible Ebola case http://t.co/UYUgFg3k1h,12,['quarantined'],1,5,4,7,quarantined,0
"Here we go again. EBOLA! Run for your lives! aaarrrgghhh!

http://t.co/G2UIMBeKgE",17,['go'],1,1,0,16,quarantined,0
Alabama Home Quarantined Over Possible Ebola├òÔò®Case http://t.co/cGKy5rw9cw,9,['Quarantined'],1,1,0,8,quarantined,0
Reddit's new content policy goes into effect many horrible subreddits banned or quarantined http://t.co/ZsXqbdUzBN http://t.co/6NCfjXPLOY,20,"['goes', 'banned', 'quarantined']",3,14,13,6,quarantined,0
#hot  Reddit's new content policy goes into effect many horrible subreddits banned or quarantined http://t.co/nGKrZPza45 #prebreak #best,23,"['goes', 'banned', 'quarantined']",3,16,15,7,quarantined,0
Officials: Alabama home quarantined over possible ... http://t.co/Rb2s0jmleJ,11,['quarantined'],1,5,4,6,quarantined,0
"Officials say a quarantine is in place at a Birmingham home over a possible Ebola case.

Edward Khan of the... http://t.co/qnIJ2p8Zv6",25,"['say', 'is']",2,1,0,24,quarantined,0
"gmtTy mhtw4fnet

Officials: Alabama home quarantined over possible Ebola case - Washington Times",14,['quarantined'],1,7,6,7,quarantined,0
Alabama home quarantined over possible Ebola case: Officials say a quarantine is in place at ... http://t.co/ztOnvgubVm #Bluehand #PJNET,24,"['quarantined', 'say', 'is']",3,3,2,21,quarantined,0
Hm MT @Ebolatrends: Alabama Home Quarantined Over Possible Ebola Case http://t.co/ihVMtmZXne http://t.co/jLieMrSnnj,18,"['Ebolatrends', 'Quarantined']",2,1,0,17,quarantined,0
Officials: Alabama home quarantined over possible Ebola case http://t.co/juW5wtOqB0,12,['quarantined'],1,5,4,7,quarantined,0
Alabama firefighters quarantined after possible Ebola exposure http://t.co/hzpX6vAQPZ reports http://t.co/L4W0PCorbs,14,['quarantined'],1,3,2,11,quarantined,0
"0nPzp mhtw4fnet

Officials: Alabama Home Quarantined Over Possible Ebola Case - ABC News",14,['Quarantined'],1,1,0,13,quarantined,0
Alabama home quarantined over possible #Ebola case: An ambulance sat outside the University of Alabama at├½Ôûê_ http://t.co/y2JT1aMyFJ,21,"['quarantined', 'sat']",2,3,2,18,quarantined,0
@famoushorse they haven't applied bans consistently. The Jew hating sub is only 'quarantined',17,"['have', 'applied', 'is', ""'quarantined""]",4,1,0,16,quarantined,0
Alabama home quarantined over possible Ebola├òÔò®case https://t.co/jr4k7IiSbu,9,['quarantined'],1,3,2,6,quarantined,0
Ebola: Alabama Home Quarantined Over Possible Ebola Case.. Related Articles: http://t.co/BiigD1LEq3,15,['Quarantined'],1,1,0,14,quarantined,0
"oc73x mhtw4fnet

Officials: Alabama home quarantined over possible Ebola case - Washington Post",14,['quarantined'],1,7,6,7,quarantined,0
I liked a @YouTube video http://t.co/V57NUgmGKT US CANADA RADIATION UPDATE EMERGENCY FISHING CLOSURES,16,['liked'],1,1,0,15,radiation emergency,0
WIPP emergency activated because of slightly elevated levels of radiation. #sejorg,13,"['activated', 'elevated']",2,1,0,12,radiation emergency,1
Jerry Brown declares state of emergency over wildfires drought street gangs radiation dead fish LGBT mania air pollution unemployment,19,['declares'],1,1,0,18,radiation emergency,0
Some of worst radiation exposure from Fukushima meltdown happened 47km northwest-Proof that small emergency planning zones don├½Ôûê┬¼t cut it,19,"['happened', 'planning', 'cut']",3,1,0,18,radiation emergency,0
SB228 [Passed] Relating to sources of radiation; and declaring an emergency. http://t.co/D1xlFKNJsM,18,"['Passed', 'declaring']",2,1,0,17,radiation emergency,0
Radioactive Box Quarantined - Israel├½Ôûê┬¼s Ashdod Port was evacuated when emergency teams discovered radiation emittin... http://t.co/swQ5lMyDka,19,"['Quarantined', 'was', 'evacuated', 'discovered']",4,1,0,18,radiation emergency,0
Radiation emergency #preparedness starts with knowing to: get inside stay inside and stay tuned http://t.co/RFFPqBAz2F via @CDCgov,22,"['starts', 'knowing', 'get', 'stay', 'tuned']",5,1,0,21,radiation emergency,1
"Rainstorm downtown Gloucester
#gloucester #capeann #seagulls #triciaoneill #triciaoneillphoto https://t.co/oLS6qdi9Um",16,['rainstorm'],1,1,0,15,rainstorm,1
DOES ANYONE REMEMBER WHEN 5SOS CAME W 1D ON THE TMH TOUR WE HAD A GIANT RAINSTORM AND LAST NIGHT WE HAD ONE ALSO. @5SOS STOP BRINING RAIN,30,['HAD'],1,1,0,29,rainstorm,0
Wow what beauty lies within every storm. Taken today after a rainstorm at A&amp;B Pipeliners http://t.co/pSt5bBQ0av,23,"['lies', 'Taken']",2,13,12,10,rainstorm,0
Rainstorm Destroys 600 Houses in Yobe State: Rainstorm Destroys 600 Houses in Yobe State. [Daily Trust] Damatu...  http://t.co/rzxQSSun02,25,['Destroys'],1,1,0,24,rainstorm,1
Another fun night. My daughter gets a flat tire on her car. Calls and doesn't know how to change it. Worst rainstorm all year. Now she knows,32,"['gets', 'does', 'know', 'change', 'knows']",5,26,25,6,rainstorm,0
'Three #people were #killed when a severe #rainstorm in the #Italian #Alps caused a #landslide' http://t.co/hAXJ6Go2ac,25,"['were', 'killed', 'caused']",3,11,10,14,rainstorm,1
Approaching rainstorm http://t.co/3YREo3SpNU,5,['Approaching'],1,2,1,3,rainstorm,0
Severe rainstorm in Italian Alps causes landslide killing three near ski resort http://t.co/DzKOKka1Eh,15,"['causes', 'killing']",2,2,1,13,rainstorm,1
Landslide in Italian Alps kills three: ROME (Reuters) - Three people were killed when a severe rainstorm in th... http://t.co/2pZ9t2FnSz,26,"['were', 'killed']",2,20,19,6,rainstorm,1
Landslide in Italian Alps kills three: ROME (Reuters) - Three people were killed when a severe rainstorm in th... http://t.co/uZwXJBG0Zh,26,"['were', 'killed']",2,20,19,6,rainstorm,1
Rainstorm Destroys 600 Houses In Yobe | iReporter https://t.co/0rNY349UnT via @sharethis,14,['rainstorm'],1,1,0,13,rainstorm,0
Landslide in Italian Alps kills three - ROME (Reuters) - Three people were killed when a severe rainstorm in the I... http://t.co/i1i1Qp5VrO,27,"['were', 'killed']",2,20,19,7,rainstorm,1
Photo: Rainstorm On The Way To Brooks Near├òÔò®Dinosaur Provincial Park Alberta July 11 2015. http://t.co/Mp9EccqvLt,18,['rainstorm'],1,1,0,17,rainstorm,0
Landslide in Italian Alps kills three: ROME (Reuters) - Three people were killed when a severe rainstorm in th... http://t.co/GX1UXeY57B,26,"['were', 'killed']",2,20,19,6,rainstorm,1
major rainstorm happening! I'm gonna lie down and drift away to the storming around me for a little while. bebacksoon.,25,"['happening', ""'m"", 'gon', 'lie', 'drift', 'storming']",6,2,1,23,rainstorm,1
Landslide in Italian Alps kills three - ROME (Reuters) - Three people were killed when a severe rainstorm in the I... http://t.co/BoygBp0Jw9,27,"['were', 'killed']",2,20,19,7,rainstorm,1
driving home after a fairly large rainstorm makes me wonder how some of y'all manage to drive when it's dry out,22,"['driving', 'makes', 'wonder', 'drive', ""'s""]",5,7,6,15,rainstorm,0
Rainstorm Update: Further North or Further South? http://t.co/50vdQ7A1M5 http://t.co/QH6oXfT9Ir,15,['rainstorm'],1,1,0,14,rainstorm,0
Nigeria: Rainstorm Destroys 600 Houses in Yobe State: [Daily Trust] Damaturu -Over 600├½Ôûê_ http://t.co/BBQnK76qUS,20,['Destroys'],1,1,0,19,rainstorm,1
Landslide in Italian Alps kills three: ROME (Reuters) - Three people were killed when a severe rainstorm in th... http://t.co/SmKZnF52Za,26,"['were', 'killed']",2,20,19,6,rainstorm,1
Tomorrow's evening commute receives a RED LIGHT. A rainstorm impacting the region will push it's way in late evening. http://t.co/DRvm8ISOtE,26,"['evening', 'receives', 'impacting', 'push', ""'s""]",5,11,10,15,rainstorm,0
That rainstorm didn't last nearly long enough,8,['did'],1,2,1,6,rainstorm,0
lizzie363 @CstSmith I drove thru deep water in a flash flood--rainstorm repair cost $14000. 25 yrs later people still thnk cars float!!!,30,"['drove', 'rainstorm', 'thnk', 'float']",4,14,13,16,rainstorm,0
Landslide in Italian Alps kills three: ROME (Reuters) - Three people were killed when a severe rainstorm in th... http://t.co/mBPWr0fUvJ,26,"['were', 'killed']",2,20,19,6,rainstorm,1
@WerdEmUp It's already been messed up thanks to an earlier rainstorm. Needs to go in for maintenance anyway.,22,"[""'s"", 'been', 'messed', 'Needs', 'go']",5,13,12,9,rainstorm,0
Welcome to Avery County! Just your everyday rainstorm. https://t.co/0Lw6GyeAgB,13,['Welcome'],1,9,8,4,rainstorm,0
rainstorm??,3,['rainstorm'],1,1,0,2,rainstorm,0
Yay I can feel the wind gearing up for a rainstorm in #Vancouver!! Bring it on #drought #deadgrassandflowers #wildfires,25,"['feel', 'gearing', 'Bring']",3,11,10,14,rainstorm,0
'The way you move is like a full on rainstorm and I'm a house of cards',18,"['move', 'is', ""'m""]",3,10,9,8,rainstorm,0
Rainstorm Destroys 600 Houses in Yobe State http://t.co/nU0D3uANNZ,10,['rainstorm'],1,1,0,9,rainstorm,1
@SavanahResnik @CBS12 I would hide out at the Coldstone at monterrey and us 1. Great place to wait out a rainstorm.,25,"['hide', 'wait']",2,24,23,1,rainstorm,0
Landslide caused by severe rainstorm kills 3 in Italian├òÔò®Alps https://t.co/8BhvxX2Xl9 http://t.co/4ou8s82HxJ,15,"['caused', 'kills']",2,5,4,10,rainstorm,1
The Latest: More Homes Razed by Northern California Wildfire - ABC News http://t.co/AKnBtuyaef,16,['Razed'],1,1,0,15,razed,1
#CecilTheLion The Latest: More Homes Razed by Northern California Wildfire - New York Times: ... http://t.co/Vi05Yq85Ly #Harare #263chat,25,['Razed'],1,1,0,24,razed,0
TENSION IN ABIA AS INEC OFFICE├½Ôûê┬¼S RAZED├òÔò®├½Ôûê├è GOVERNOR IKPEAZU PDP APGA REACT http://t.co/aKzZOe5CE6,15,['razed'],1,1,0,14,razed,0
The Latest: More homes razed by Northern California wildfire: The latest on wildfires burning in California and├½Ôûê_ http://t.co/0Keh2TReNy,22,"['razed', 'burning']",2,6,5,16,razed,1
'The Latest: More Homes Razed by Northern California Wildfire' by THE ASSOCIATED PRESS via NYT http://t.co/rDF0ZuW7lZ,20,['Razed'],1,1,0,19,razed,1
The Latest: More homes razed by Northern California wildfire - http://t.co/nTSwUAYEJI http://t.co/wgeFBuk4Jk,17,['razed'],1,6,5,11,razed,1
#?? #?? #??? #??? The Latest: More Homes Razed by Northern California Wildfire - New York Times  http://t.co/IPnHSIyorc-,31,['Razed'],1,1,0,30,razed,1
The Latest: More Homes Razed by Northern California Wildfire - ABC News http://t.co/ZBZc8905Gl,16,['Razed'],1,1,0,15,razed,1
The Latest: More Homes Razed by Northern California Wildfire - ABC News http://t.co/lY8x7rqbwN,16,['Razed'],1,1,0,15,razed,1
http://t.co/iXiYBAp8Qa The Latest: More homes razed by Northern California wildfire - Lynchburg News and Advance http://t.co/zEpzQYDby4,21,"['//t.co/iXiYBAp8Qa', 'razed']",2,9,8,12,razed,0
#News : The Latest: More Homes Razed by Northern California Wildfire - New York Times http://t.co/5kBRZZmf8c #TAFS #FB100%,25,['Razed'],1,1,0,24,razed,0
The Latest: More Homes Razed by Northern California Wildfire - ABC News http://t.co/d1VjOYg52A,16,['Razed'],1,1,0,15,razed,1
The Latest: More Homes Razed by Northern California Wildfire - ABC News http://t.co/dOFRh5YB01,16,['Razed'],1,1,0,15,razed,1
The Latest: More Homes Razed by Northern California Wildfire - ABC News http://t.co/55IdFT20A2 http://t.co/2VSX1yO5hT,19,['Razed'],1,1,0,18,razed,1
The Latest: More homes razed by Northern California wildfire - http://t.co/2nIP3d15dx http://t.co/egYFNlAOQv,17,['razed'],1,6,5,11,razed,1
The Latest: More homes razed by Northern California wildfire - http://t.co/BsGR67dyWY http://t.co/nDGgr6Xyqd,17,['razed'],1,6,5,11,razed,1
The Latest: More homes razed by Northern California wildfire - http://t.co/5FcJVMl520 http://t.co/fvYRWhux8p,17,['razed'],1,6,5,11,razed,1
The Latest: More Homes Razed by Northern California Wildfire - ABC News http://t.co/ATokCD74bA,16,['Razed'],1,1,0,15,razed,1
The Latest: More homes razed by Northern California wildfire - http://t.co/3tnuACIV3c http://t.co/SAkORGdqUL,17,['razed'],1,6,5,11,razed,1
The Latest: More homes razed by Northern California wildfire - http://t.co/P3g3bQBczu http://t.co/RpBxdfnx5k,17,['razed'],1,6,5,11,razed,1
The Latest: More Homes Razed by Northern California Wildfire - ABC News http://t.co/x1xj0XVTj7,16,['Razed'],1,1,0,15,razed,1
@DavidVonderhaar At least you were sincere ??,9,['were'],1,1,0,8,razed,0
ABC News The Latest: More Homes Razed by Northern California Wildfire ABC News The latest on├½Ôûê_ http://t.co/RruNs5rDz5,20,['Razed'],1,1,0,19,razed,0
World News&gt;&gt; 'The Latest: More homes razed by Northern California wildfire - http://t.co/M6OK4EH3ob' http://t.co/VGa0OhB6XF,26,['razed'],1,14,13,12,razed,1
The Latest: More Homes Razed by Northern California Wildfire - ABC News http://t.co/Rg9yaybOSA,16,['Razed'],1,1,0,15,razed,1
The Latest: More Homes Razed by Northern California Wildfire - ABC News http://t.co/2872J5d4HB,16,['Razed'],1,1,0,15,razed,1
The Latest: More homes razed by Northern California wildfire - http://t.co/ecXMoiNZgU http://t.co/ntwWDweDNb,17,['razed'],1,6,5,11,razed,1
More homes razed by Northern Calif. wildfire http://t.co/u52RW9Ji2r #sandiego http://t.co/GX75w3q9Ye,15,['razed'],1,3,2,12,razed,1
George Njenga the hero saved his burning friend from a razing wildfire http://t.co/Ywkk26arAG,15,"['saved', 'burning', 'razing']",3,1,0,14,razed,0
The Latest: More Homes Razed by Northern California Wildfire - ABC News http://t.co/bKsYymvIsg #GN,18,['Razed'],1,1,0,17,razed,1
The Latest: More homes razed by Northern California wildfire - SFGate http://t.co/65hunplHYB,15,['razed'],1,6,5,9,razed,1
The Latest: More Homes Razed by Northern California Wildfire - ABC News http://t.co/RlPTtkBG4W,16,['Razed'],1,1,0,15,razed,1
The Latest: More Homes Razed by Northern California Wildfire - ABC News http://t.co/ORdoKfUIBm,16,['Razed'],1,1,0,15,razed,1
The Latest: More Homes Razed by Northern California Wildfire - ABC News http://t.co/6AcSWzo7cw,16,['Razed'],1,1,0,15,razed,1
The Latest: More Homes Razed by Northern California Wildfire - ABC News http://t.co/hCKxJ8eukt,16,['Razed'],1,1,0,15,razed,1
The Latest: More homes razed by #NorthernCalifornia wildfire http://t.co/mONiJJth7V #ZippedNews http://t.co/0yXBB5dzw5,18,['razed'],1,6,5,12,razed,1
The Latest: More homes razed by Northern California wildfire - http://t.co/R1CNSjUAYQ http://t.co/DQ1yLcrF9K,17,['razed'],1,6,5,11,razed,1
George Njenga the hero saved his burning friend from a razing wildfire... http://t.co/us8r6Qsn0p,16,"['saved', 'burning']",2,1,0,15,razed,1
The Latest: More Homes Razed by Northern California Wildfire - ABC News http://t.co/lj4J54vxq3,16,['Razed'],1,1,0,15,razed,1
The Latest: More Homes Razed by Northern California Wildfire - ABC News http://t.co/aueZxZA5ak,16,['Razed'],1,1,0,15,razed,1
The Latest: More Homes Razed by Northern California Wildfire - ABC News http://t.co/VP6wbXMZmj,16,['Razed'],1,1,0,15,razed,1
This just-married Turkish couple gave 4000 Syrian refugees an incredible gift http://t.co/ibeD3xG7fy Fed them instead of family &amp; friends.,24,"['gave', 'refugees']",2,8,7,16,refugees,0
Police Monitoring 200 Jihadis in Poland http://t.co/1wCOfmLUb9 via @freedomoutpost,12,['refugees'],1,1,0,11,refugees,0
'imagine an entire aisle dedicated to making people look like serbian refugees.' - director of whole foods clothing section,21,"['dedicated', 'making', 'look']",3,12,11,9,refugees,0
This just-married Turkish couple gave 4000 Syrian refugees an incredible gift #WashingtonPost http://t.co/aRKmc7vclN,16,"['gave', 'refugees']",2,8,7,8,refugees,0
12000 Nigerian refugees repatriated from Cameroon http://t.co/LeLYa0vDOg read /////,11,"['repatriated', 'read']",2,3,2,8,refugees,0
#retweet Cameroon repatriating about 12000 Nigerian refugees due to Boko Haram http://t.co/wvVgmejA7l,15,['repatriating'],1,8,7,7,refugees,0
wowo--=== 12000 Nigerian refugees repatriated from Cameroon,9,['repatriated'],1,6,5,3,refugees,0
./.....hmm 12000 Nigerian refugees repatriated from Cameroon http://t.co/YTW9SlWvmg /(,14,"['..hmm', 'repatriated']",2,6,5,8,refugees,0
...//..// whao.. 12000 Nigerian refugees repatriated from Cameroon http://t.co/baE0Ap4G9Y,12,"['whao..', 'repatriated']",2,6,5,6,refugees,0
reaad/ plsss 12000 Nigerian refugees repatriated from Cameroon,8,"['plsss', 'repatriated']",2,5,4,3,refugees,0
Refugee Connections Indiegogo campaign will be going live tomorrow! Support us and help launch the only online community for #refugees.,23,"['be', 'going', 'help', 'launch']",4,22,21,1,refugees,0
y'all read 12000 Nigerian refugees repatriated from Cameroon http://t.co/aVwE1LBvhn,11,"['read', 'repatriated']",2,5,4,6,refugees,0
Short of throwing them overboard himself I don't think any other leader could do much worse by #refugees than @TonyAbbottMHR worst pm ever!,27,"['throwing', 'do', 'think', 'do']",4,20,19,7,refugees,0
Cameroon Repatriated 12000 Nigerian Refugees http://t.co/6nQRU2q5Tz,8,['Repatriated'],1,1,0,7,refugees,0
wowo--=== 12000 Nigerian refugees repatriated from Cameroon,9,['repatriated'],1,6,5,3,refugees,0
How One Couple Is Using Drones to Save Refugees at the World's Deadliest Border http://t.co/9qpG0Z3Rh9,18,"['Is', 'Using', 'Save']",3,1,0,17,refugees,0
...//..// whao.. 12000 Nigerian refugees repatriated from Cameroon http://t.co/HuhWPmryWz,12,"['whao..', 'repatriated']",2,6,5,6,refugees,0
./.....hmm 12000 Nigerian refugees repatriated from Cameroon http://t.co/96p3hUJNTj /(,14,"['..hmm', 'repatriated']",2,6,5,8,refugees,0
"@fadelurker @dalinthanelan &lt; right now.

Even after two years there were still refugees camped just south of Redcliffe village and Aidan &gt;",29,"['were', 'refugees', 'camped']",3,18,17,11,refugees,0
In Photos: The Young Refugees Forced to Flee Burundi's Violence | VICE News https://t.co/jOjnq2oOPi see more http://t.co/DsKuI6Mmgl,23,['see'],1,1,0,22,refugees,0
Top story: @ViralSpell: 'Couple spend wedding day feeding 4000 Syrian refugees├½Ôûê_ http://t.co/5lMo710D5f see more http://t.co/G9LREAlToJ,22,"['spend', 'wedding', 'feeding', 'see']",4,14,13,8,refugees,0
./.....hmm 12000 Nigerian refugees repatriated from Cameroon http://t.co/FVTj8qwJZW /(,14,"['..hmm', 'repatriated']",2,6,5,8,refugees,0
Newlyweds feed thousands of Syrian refugees instead of hosting a banquet wedding dinner -  http://t.co/XZV0lT9ZZk via @smh,20,"['feed', 'hosting']",2,6,5,14,refugees,0
.@PeterDutton_MP Maintaining the integrity of our borders while not maintaining human rights of our refugees. Nice trade off.,22,"['maintaining', 'trade']",2,17,16,5,refugees,0
recap/ 12000 Nigerian refugees repatriated from Cameroon http://t.co/po19h8YCND,10,['repatriated'],1,4,3,6,refugees,0
...//..// whao.. 12000 Nigerian refugees repatriated from Cameroon http://t.co/aVwE1LBvhn,12,"['whao..', 'repatriated']",2,6,5,6,refugees,0
Still wonder why they will do anything to have a life anywhere. Wars u support CAUSE refugees open boarders. #auspol https://t.co/3MjtE74AiW,26,"['wonder', 'do', 'have', 'refugees']",4,18,17,8,refugees,0
reaad/ plsss 12000 Nigerian refugees repatriated from Cameroon,8,"['plsss', 'repatriated']",2,5,4,3,refugees,0
...//..// whao.. 12000 Nigerian refugees repatriated from Cameroon http://t.co/po19h8YCND,12,"['whao..', 'repatriated']",2,6,5,6,refugees,0
The 46 returned refugees - what were they fleeing from &amp; how will the Vietnamese Govt treat them now they are returned? #Dutton #presser,29,"['returned', 'were', 'fleeing', 'treat', 'are', 'returned']",6,4,3,25,refugees,0
CHPSRE: RT: Refugees: For our followers in Paris do visit 'A Dream of Humanity' exhibition by rezaphotography ├½Ôûê_ ├½Ôûê_ http://t.co/RPmTROPsVr,27,['do'],1,1,0,26,refugees,0
@bcook28 @zacktiller30 bring in the rescue squad ??,11,['rescue'],1,8,7,3,rescue,0
Policyholders object to Clico rescue plan http://t.co/E4DvI9vUXZ http://t.co/JyCpf8iYhg,12,"['object', 'http']",2,5,4,7,rescue,0
Florida Firefighters Rescue Scared Meowing Kitten from Vent Shaft http://t.co/RVKffcxbvC #fire #firefighter,16,['rescue'],1,1,0,15,rescue,0
UD: Rescue (Structural Collapse) - Scott Road @ Ypres Road York (14 Trucks),18,['rescue'],1,1,0,17,rescue,0
Officials rescue 367 migrants off Libya; 25 bodies found - Fox News http://t.co/9CAignPR6S #NoAgenda #MvDint,20,"['rescue', 'found']",2,2,1,18,rescue,0
Beauty Deals : http://t.co/eUd317Eptp #4552 Lot of 50Mixed Colors 7.5' Scissors FirstAid Princess Care Rescue Tr├½Ôûê_ http://t.co/mAHkV79SmW,23,['rescue'],1,1,0,22,rescue,0
UD: Rescue (Structural Collapse) - Scott Road @ Ypres Road York (14 Trucks),18,['rescue'],1,1,0,17,rescue,0
Flood-zone : General Raheel Sharif visits Chitral: He  also lauded the efforts of  FWO army troops and army aviation in rescue opera...,24,"['visits', 'lauded']",2,22,21,2,rescue,0
Officials rescue 367 migrants off Libya; 25 bodies found - Fox News http://t.co/cEdCUgEuWs #News,18,"['rescue', 'found']",2,2,1,16,rescue,0
"Revel8ion Media recently went out to support the 'Rocky Fire' rescue efforts. This is what we filmed.
#RockyFire  http://t.co/Haxz4XLs8d",25,"['went', 'support', 'is', 'filmed']",4,12,11,13,rescue,0
@Zak_Bagans this is Sabrina my dad rescued her from some dude who kept her in a cage. We've had her since I was 4 http://t.co/1k2PhQcuW8,30,"['is', 'rescued', 'kept', ""'ve"", 'had', 'was']",6,8,7,22,rescued,0
Britons rescued amid Himalaya floods (http://t.co/WGRXLy9pDO) http://t.co/BJ4hAAVAYE http://t.co/59p3AoIQUS,16,['rescued'],1,2,1,14,rescued,0
4 kidnapped ladies rescued by police in Enugu | Nigerian Tribune http://t.co/xYyEV89WIz,14,"['kidnapped', 'rescued']",2,4,3,10,rescued,0
Rescued Med migrants arrive in Sicily http://t.co/Z8xIqNgulc,9,"['Rescued', 'arrive']",2,1,0,8,rescued,0
Worker rescued from top of Central Street water tower in Summerside http://t.co/MkMlCTYmee,14,['rescued'],1,2,1,12,rescued,0
10-Month-Old Baby Girl was Rescued by Coastguard after She Floated HALF A MILE Out to Sea! #socialnews http://t.co/kJUzJC6iGD,22,"['was', 'Rescued', 'Floated']",3,1,0,21,rescued,0
10-Month-Old Baby Girl was Rescued by Coastguard after She Floated HALF A MILE Out to Sea! http://t.co/kJUzJC6iGD,20,"['was', 'Rescued', 'Floated']",3,1,0,19,rescued,0
Rescued Med migrants arrive in Sicily http://t.co/nekm1RPohU,9,"['Rescued', 'arrive']",2,1,0,8,rescued,0
18 bovines rescued 3 smugglers├òÔò®nabbed http://t.co/E7fn5G5rUu,8,['rescued'],1,3,2,5,rescued,0
#news Britons rescued amid Himalaya floods http://t.co/kEPznhXHXd,10,['rescued'],1,4,3,6,rescued,0
British trekkers rescued amid flash floods in Himalayas - BBC News,11,['rescued'],1,3,2,8,rescued,0
@BrittanyPetko breaking news tonight kids were rescued from play room after a week with no food or water do to parents sex life haha,25,"['breaking', 'were', 'rescued', 'do', 'parents']",5,8,7,17,rescued,0
http://t.co/QGyN2u1UP3 Rescued Med migrants arrive in Sicily: Hundreds of migrants rescued├½Ôûê_ http://t.co/wiS3H9Tqrm,17,['arrive'],1,14,13,3,rescued,0
SkyNews: Migrant Boat Tragedy Survivors Arrive In Italy - Migrants rescued http://t.co/FORBy6MmKp,15,['rescued'],1,12,11,3,rescued,0
nigeriantribune: 4 kidnapped ladies rescued by police in Enugu | Nigerian Tribune http://t.co/7hmHpl1Z4y,16,"['kidnapped', 'rescued']",2,6,5,10,rescued,0
Why weren't they taken back to Africa once rescued? #c4news,13,"['were', 'taken', 'rescued']",3,10,9,3,rescued,0
Migrants Rescued After Boat Capsizes Off Libya http://t.co/pmGgavtokP,10,['Rescued'],1,1,0,9,rescued,0
NAIROBI Kenya (AP) ├½Ôûê├ï Two people died and 25 others were rescued after a passenger boat with about two dozen passengers collided with a,26,"['├½Ôûê├ï', 'died', 'were', 'rescued', 'collided']",5,14,13,12,rescued,0
Young children among those rescued from capsized boat off Libya http://t.co/Kot9zVD2H7 via @IrishTimesWorld,16,"['rescued', 'capsized']",2,5,4,11,rescued,0
Heroes! A Springer Spaniel &amp; her dog dad rescued a stranded baby dolphin: http://t.co/G03DkPooNP http://t.co/Go0HPi0B4c,23,['rescued'],1,12,11,11,rescued,0
Three beached whales rescued in Kerry - http://t.co/rQbsPUCjDF,10,"['beached', 'rescued']",2,4,3,6,rescued,0
Britons rescued amid Himalaya floods http://t.co/8f2YBus2Vk,8,['rescued'],1,2,1,6,rescued,0
Photo: Hundreds of rescued migrants await disembarkment from an Irish naval vessel at Palermo Italy - @tconnellyR├½Ôûê_ https://t.co/AIM5CYHL0y,22,['await'],1,5,4,17,rescued,0
Rescued Med migrants arrive in Sicily http://t.co/p4dOA5YYJe,9,"['Rescued', 'arrive']",2,1,0,8,rescued,0
VIDEO: 'We're picking up bodies from water': Rescuers are searching for hundreds of migrants in ... http://t.co/bS6PjT09Tc #Africa #News,27,"[""'re"", 'picking', 'are', 'searching']",4,1,0,26,rescuers,0
VIDEO: 'We're picking up bodies from water': Rescuers are searching for hundreds of migrants in the Mediterran... http://t.co/s5NuEGSwYj,25,"[""'re"", 'picking', 'are', 'searching']",4,1,0,24,rescuers,0
VIDEO: 'We're picking up bodies from water': Rescuers are searching for hundreds of migrants in the Mediterran... http://t.co/ciwwUQthin,25,"[""'re"", 'picking', 'are', 'searching']",4,1,0,24,rescuers,0
Rescuers recover body of 37-year-old Calgary man from lake near Vulcan http://t.co/araUSJvsy9 http://t.co/U7ZWlk8THX,17,['recover'],1,1,0,16,rescuers,0
VIDEO: 'We're picking up bodies from water': Rescuers are searching for hundreds of migrants in the Mediterran... http://t.co/GEU4H46CsZ,25,"[""'re"", 'picking', 'are', 'searching']",4,1,0,24,rescuers,0
VIDEO: 'We're picking up bodies from water' - Rescuers are searching for hundreds of migrants in the Mediterranean... http://t.co/yhQU5UV6Ok,25,"[""'re"", 'picking', 'are', 'searching']",4,1,0,24,rescuers,0
#italy Hundreds of Migrants Rescued After Boat Capsizes Off Libya: Rescuers saved 400 people though 25 died w... http://t.co/e48syD5N1E,24,"['saved', 'died']",2,1,0,23,rescuers,0
#world Fears over missing migrants in Med: Rescuers search for survivors after a boat carrying as many a... http://t.co/6DS67XAI5e #news,26,"['missing', 'search', 'carrying']",3,1,0,25,rescuers,0
@Durban_Knight Rescuers are searching for hundreds of migrants in the Mediterranean after a boat carr... http://t.co/cWCVBuBs01 @Nosy_Be,22,"['are', 'searching']",2,1,0,21,rescuers,0
VIDEO: 'We're picking up bodies from water': Rescuers are searching for hundreds of migrants in the Mediterran... http://t.co/WvMHX5tiel,25,"[""'re"", 'picking', 'are', 'searching']",4,1,0,24,rescuers,0
Rescuers are searching for hundreds of migrants in the Mediterranean after a boat carrying as many as 600 people├½Ôûê_,19,"['are', 'searching', 'carrying']",3,1,0,18,rescuers,0
Bay Whale Worries Rescuers http://t.co/nfKTvVLWHm,7,['rescuers'],1,1,0,6,rescuers,0
#RoddyPiperAutos Fears over missing migrants in Med: Rescuers search for survivors after a boat carrying as ma...  http://t.co/97B8AVgEWU,23,"['missing', 'search']",2,1,0,22,rescuers,0
The Rescuers and The Rescuers Down Under are on Netflix├½Ôûê_ You├½Ôûê┬¼re welcome.,13,['are'],1,1,0,12,rescuers,0
VIDEO: 'We're picking up bodies from water': Rescuers are searching for hundreds of migrants in the Mediterranean after a boat carryi...,26,"[""'re"", 'picking', 'are', 'searching']",4,1,0,25,rescuers,0
Woman├½Ôûê┬¼s GPS app guides rescuers to injured biker in Marin County http://t.co/UoJy4E2Sv4,14,"['app', 'injured']",2,5,4,9,rescuers,0
Fears over missing migrants in Med: Rescuers search for survivors after a boat carrying as many as 600 migrants├½Ôûê_ http://t.co/UUHNC8ZkOW,23,"['missing', 'search', 'carrying']",3,1,0,22,rescuers,1
VIDEO: 'We're picking up bodies from water': Rescuers are searching for hundreds of migrants in the Mediterran... http://t.co/zG1YddywA5,25,"[""'re"", 'picking', 'are', 'searching']",4,1,0,24,rescuers,0
VIDEO: 'We're picking up bodies from water': Rescuers are searching for hundreds of migrants in the Mediterran... http://t.co/PUezv6bd37,25,"[""'re"", 'picking', 'are', 'searching']",4,1,0,24,rescuers,0
VIDEO: 'We're picking up bodies from water': Rescuers are searching for hundreds of migrants in the Mediterranean after a boat carryi...,26,"[""'re"", 'picking', 'are', 'searching']",4,1,0,25,rescuers,0
VIDEO: 'We're picking up bodies from water': Rescuers are searching for hundreds of migrants in ... http://t.co/awtScUCBBV #Africa #News,27,"[""'re"", 'picking', 'are', 'searching']",4,1,0,26,rescuers,0
VIDEO: 'We're picking up bodies from water': Rescuers are searching for hundreds of migrants in the Mediterranean after a boat carryi...,26,"[""'re"", 'picking', 'are', 'searching']",4,1,0,25,rescuers,0
VIDEO: 'We're picking up bodies from water': Rescuers are searching for hundreds of migrants in the Mediterran... http://t.co/xJm6Snk1G0,25,"[""'re"", 'picking', 'are', 'searching']",4,1,0,24,rescuers,0
VIDEO: 'We're picking up bodies from water': Rescuers are searching for hundreds of migrants in the Mediterranean after a boat carryi...,26,"[""'re"", 'picking', 'are', 'searching']",4,1,0,25,rescuers,0
"#WorldNews
 VIDEO: 'We're picking up bodies from water' - BBC News - Home:
Rescuers are searching for hundreds of.. http://t.co/6hhmBdK9Yo",27,"[""'re"", 'picking', 'are', 'searching']",4,1,0,26,rescuers,0
VIDEO: 'We're picking up bodies from water': Rescuers are searching for hundreds of migrants in the Mediterran... http://t.co/ZFWMjh6SLh,25,"[""'re"", 'picking', 'are', 'searching']",4,1,0,24,rescuers,0
http://t.co/XlFi7ovhFJ VIDEO: 'We're picking up bodies from water': Rescuers are searching for hundreds├½Ôûê_ http://t.co/rAq4ZpdvKe,22,"[""'re"", 'picking', 'are', 'searching']",4,1,0,21,rescuers,0
AH-Mazing story of the power animal rescuers have! A starving homeless dog with no future was rescued by a person... http://t.co/ficd5qbqwl,25,"['have', 'starving', 'was', 'rescued']",4,7,6,18,rescuers,0
Woman├½Ôûê┬¼s GPS app guides rescuers to injured biker in Marin County http://t.co/hKv8XKtU2k,14,"['app', 'injured']",2,5,4,9,rescuers,0
VIDEO: 'We're picking up bodies from water': Rescuers are searching for hundreds of migrants in the Mediterran... http://t.co/biiiYi7DaE,25,"[""'re"", 'picking', 'are', 'searching']",4,1,0,24,rescuers,0
Rescuers are searching for hundreds of migrants in the Mediterranean after a boat carrying as many as 600 people capsized off the coast of├½Ôûê_,24,"['are', 'searching', 'carrying', 'capsized']",4,1,0,23,rescuers,1
#News: 'Many deaths' in shipwreck: Rescuers are trying to save hundreds of migrants after the... http://t.co/tX51oYbrN6 via @TheNewsHype,26,"['are', 'trying', 'save']",3,1,0,25,rescuers,1
VIDEO: 'We're picking up bodies from water': Rescuers are searching for hundreds of migrants in the Mediterran... http://t.co/PsPm3ahGKQ,25,"[""'re"", 'picking', 'are', 'searching']",4,1,0,24,rescuers,0
News Break Nigeria Rescuers search for survivors after a boat carrying as many as 600 migrants capsizes in the... http://t.co/lNiTVT7B53,23,"['carrying', 'capsizes']",2,1,0,22,rescuers,0
VIDEO: 'We're picking up bodies from water': Rescuers are searching for hundreds of migrants in the Mediterran... http://t.co/yvO6q6W442,25,"[""'re"", 'picking', 'are', 'searching']",4,1,0,24,rescuers,0
When Rescuers Found Him He Was Barely Alive. But They Had No Idea He Was Allergic To THIS! http://t.co/VecmsiUUh1,23,"['Found', 'Had', 'Was', 'THIS']",4,1,0,22,rescuers,0
Fears over missing migrants in Med: Rescuers search for survivors after a boat carrying as many as 600 migrant... http://t.co/gx9sKUAu9J,24,"['missing', 'search', 'carrying']",3,1,0,23,rescuers,1
VIDEO: 'We're picking up bodies from water': Rescuers are searching for hundreds of migrants in the Mediterranean after a boat carryi...,26,"[""'re"", 'picking', 'are', 'searching']",4,1,0,25,rescuers,0
Woman's GPS app guides rescuers to injured biker in Marin County - SFGate http://t.co/Iz9U8BhfAA,17,"['guides', 'injured']",2,6,5,11,rescuers,0
When Rescuers Found Him He ... http://t.co/sTDCdHQxJX,9,['Found'],1,1,0,8,rescuers,0
VIDEO: 'We're picking up bodies from water': Rescuers are searching for hundreds of migrants in the Mediterran... http://t.co/XfS3pJhFh9,25,"[""'re"", 'picking', 'are', 'searching']",4,1,0,24,rescuers,0
Fears over missing migrants in Med: Rescuers search for survivors after a boat carrying as many as 600 migrants├½Ôûê_ http://t.co/v9ftYB30EI,23,"['missing', 'search', 'carrying']",3,1,0,22,rescuers,1
Rescuers find survivors of Nepal earthquake buried ... http://t.co/I8SJ1KWs1D,11,"['find', 'buried']",2,1,0,10,rescuers,0
"Rescuers recover body of 37-year-old Calgary man from lake near Vulcan 
                            
             ├½Ôûê_ http://t.co/gAEhr9bHEk",15,['recover'],1,1,0,14,rescuers,0
Fears over missing migrants in Med: Rescuers search for survivors after a boat carrying as many as 600 migrants├½Ôûê_ http://t.co/IXfnE5Jlep,23,"['missing', 'search', 'carrying']",3,1,0,22,rescuers,1
VIDEO: 'We're picking up bodies from water': Rescuers are searching for hundreds of migrants in the... http://t.co/UymxocFs33 #BBC #News,28,"[""'re"", 'picking', 'are', 'searching']",4,1,0,27,rescuers,0
@CHold ironically RSL call their stadium the Riot,9,['call'],1,1,0,8,riot,0
@PipRhys I predict a riot.,7,['predict'],1,6,5,1,riot,0
@Live_Workshop selfie at booth or riot Kappa,8,['riot'],1,7,6,1,riot,0
To All The Meat-Loving Feminists Of The World Riot Grill Has Arrived http://t.co/TiOst8oKvX,15,['Arrived'],1,1,0,14,riot,0
@Riot_Sweet @jfwong @MtgoDoc @JoshLeeKwai wait.. what dates?? ill be at MSG and PAX =(,21,"['wait..', 'dates', 'be']",3,1,0,20,riot,0
#ModiMinistry Stuart Broad Takes Eight Before Joe Root Runs Riot Against Aussies http://t.co/rc22r1xlIs,16,['riot'],1,1,0,15,riot,0
I'm Role Play of Ulzzang Park Hyung Seok. 92 Liners. Be bleased with me. I'll do the same.,24,"[""'m"", 'Be', 'bleased', 'do']",4,1,0,23,riot,0
Riot police intervene after Southampton and Vitesse Arnhem supporters clash: ├½Ôûê├│ Fans clash in buildup to second leg├½Ôûê_ http://t.co/I8GX67wbGv,22,"['clash', 'clash']",2,1,0,21,riot,0
Riot police intervene after Southampton and Vitesse Arnhem supporters clash: ├½Ôûê├│ Fans clash in buildup to second... http://t.co/OBBcoMKAWf,22,"['clash', 'clash', 'second']",3,1,0,21,riot,0
@DavidJordan88 @Stephanenny Except we don't know who started the riot or if it even makes sense to credit any particular individuals...,25,"['do', 'know', 'started', 'makes']",4,13,12,12,riot,0
Sweetpea's are running riot at the allotment - and brightening up a rainy day http://t.co/6NdBFOPK5m,18,"['are', 'running', 'brightening']",3,5,4,13,riot,0
Riot police intervene after Southampton and Vitesse Arnhem supporters clash: ├½Ôûê├│ Fans clash in buildup to second... http://t.co/sKVNmtZGeG,22,"['clash', 'clash', 'second']",3,1,0,21,riot,0
But the government will not care. Police will stop rioting eventually of protestors. Eventually some skyscrapers become plant-covered .,21,"['care', 'stop', 'rioting', 'become']",4,11,10,10,rioting,0
Eric Clapton shot the sheriff in 1974 and guess how many people were rioting? Right none.,18,"['shot', 'guess', 'were', 'rioting']",4,14,13,4,rioting,0
'Money can't buy happiness' is just a lie we tell poor people to keep them from rioting.,20,"['buy', 'is', 'tell', 'keep', 'rioting']",5,19,18,1,rioting,0
Bloody hell it's already been upgraded to 'rioting'. #hyperbole #saintsfc,15,"['hell', ""'s"", 'been', 'upgraded', ""'rioting""]",5,1,0,14,rioting,0
#BHRAMABULL Watch Run The Jewels Use Facts to Defend Rioting in Ferguson: The socially minded duo takes on the... http://t.co/9iP2vqHFWi,25,"['Facts', 'Defend', 'takes']",3,1,0,24,rioting,0
Twitter is doing a count down to the rioting and financial collapse of Brazil #Rio2016 http://t.co/9mtrq5Jf4d,19,"['is', 'doing']",2,9,8,10,rioting,0
http://t.co/wspuXOrEWb  Cindy Noonan@CindyNoonan-Heartbreak in #Baltimore #Rioting #YAHIstorical #UndergroundRailraod,16,['rioting'],1,1,0,15,rioting,0
Leeds fan.... rioting in Embra at a lower tier/ league cup final ... dee dum,17,['rioting'],1,5,4,12,rioting,0
Still rioting in a couple of hours left until I have to be up for class.,17,"['rioting', 'left', 'have', 'be']",4,2,1,15,rioting,1
"@evacide The Ferguson RIOTS worked. This of this the next time you say RIOTING doesn't change anything.

There fixed it for you.",27,"['worked', 'say', 'does', 'change', 'fixed']",5,1,0,26,rioting,0
#BHRAMABULL Watch Run The Jewels Use Facts to Defend Rioting in Ferguson: The socially minded duo takes on the... http://t.co/y9eTXHCvjr,25,"['Facts', 'Defend', 'takes']",3,1,0,24,rioting,0
`bbcnews The Ass. of British Insurers says rioting will cost insurers  &amp;#163;163;millions. But police numbers are reduced by blind fat contr,32,"['bbcnews', 'says', 'cost', 'are', 'reduced']",5,10,9,22,rioting,0
#BHRAMABULL Watch Run The Jewels Use Facts to Defend Rioting in Ferguson: The socially minded duo takes on the... http://t.co/Ld5P1sIa2N,25,"['Facts', 'Defend', 'takes']",3,1,0,24,rioting,0
I have stopped trying to figure out if THIS will be the misogyny/racism/religion-fueled shooting that will incite rioting.,19,"['have', 'stopped', 'trying', 'figure', 'be', 'incite']",6,18,17,1,rioting,0
@BLutz10 People aren't rioting because justice has been served and that murderer is behind bars. Simple! No justice=no peace Justice=peace.,25,"['are', 'rioting', 'has', 'been', 'served', 'is']",6,6,5,19,rioting,1
'Dont use \Allahuakbar\'' and start rioting. Do you guys even listen to yourselves? #SHAME''',20,"['start', 'Do', 'guys', 'listen', 'yourselves']",5,7,6,13,rioting,0
@jasalhad @brianboru67 @Jimskiv92 @hijinks1967 Rioting.,10,['jasalhad'],1,1,0,9,rioting,0
@foxandfriends where is protest looting and rioting that is for ignorant people,13,"['is', 'is']",2,8,7,5,rioting,0
@brownblaze on tumblr the day/night of it was all over. The first I heard anything about it anywhere elsewere simply reports of rioting.,26,"['was', 'heard']",2,25,24,1,rioting,0
RT : Why Sweden Isn't Venezuela: There have been a few days of rioting in Venezuela with the riots directed at gr├½Ôûê_ http://t.co/GJfd85vuf2,27,"['Is', 'have', 'been', 'directed']",4,16,15,11,rioting,0
The last time a high profile name was due to be signing for #nffc the City was rioting! Wesley Verhoek now a household name! #don'tpanic,29,"['was', 'be', 'signing', 'was', 'rioting']",5,19,18,10,rioting,0
.@runjewels appear in a new video by @BBC defending the riots in Ferguson: http://t.co/veh1seVDKO http://t.co/h2GziEfJXt,23,"['appear', 'defending']",2,1,0,22,rioting,0
Half of Australia is currently rioting because they think 'Extras' is an aboriginal cricketer stealing their sport.,19,"['is', 'rioting', 'think', 'is', 'stealing']",5,6,5,13,rioting,1
@halljh1720. I am so sick of criminals parents and friends rioting when they are killed by police. You don't give a Damn when officer is.,30,"['am', 'rioting', 'are', 'killed', 'do', 'give', 'is']",7,13,12,17,rioting,0
@BLutz10 But the rioting began prior to the decision for the indictment so you're not really making sense at this point├½Ôûê_,23,"['began', ""'re"", 'making']",3,5,4,18,rioting,0
The Ashes Test match is currently more interesting than stupid Congress rioting...,13,['is'],1,12,11,1,rioting,0
"people rioting everywhere and I think I'd be one of them.'

Usami-san &lt;3",19,"['rioting', 'think', 'be']",3,2,1,17,rioting,0
Football hooligan jailed for rioting before game in Scotland was already banned from matches in England #UkNews http://t.co/q5mp2Q6Hy8,21,"['jailed', 'rioting', 'was', 'banned']",4,5,4,16,rioting,0
AM `bbcnews The Ass British Insurers says rioting will cost insurers163;millions. But police numbers are reduced by blind fat controllers.,25,"['bbcnews', 'says', 'cost', 'are', 'reduced']",5,9,8,16,rioting,0
http://t.co/DYKYpy3vA5  Cindy Noonan@CindyNoonan-Heartbreak in #Baltimore #Rioting #YAHIstorical #UndergroundRailraod,16,['rioting'],1,1,0,15,rioting,0
@fa07af174a71408 I have lived &amp; my family have lived in countries where looters were shot on sight where rioting wasn't tolerated. Why here,28,"['have', 'lived', 'have', 'lived', 'were', 'shot', 'was', 'tolerated']",8,22,21,6,rioting,0
@accionempresa China├½Ôûê┬¼s stock market crash this summer has sparked interest from bargain hunt... http://t.co/s0Eyq1wEHE @gerenciatodos ├ò┬┐,21,"['has', 'sparked']",2,1,0,20,rubble,0
#360WiseNews : China's Stock Market Crash: Are There Gems In The Rubble? http://t.co/QDwRjmmk89,19,['Are'],1,1,0,18,rubble,0
#forbes #europe China's Stock Market Crash: Are There Gems In The Rubble? http://t.co/C0SlAbBP7j,20,"['europe', 'Are']",2,1,0,19,rubble,0
@JasonPope2 @JohnFugelsang again I didn't say it was. I was referring to the main 2 buildings. 7 was hit by rubble,26,"['did', 'say', 'was', 'was', 'referring', 'was', 'hit']",7,26,25,0,rubble,0
China├½Ôûê┬¼s e-commerce firms Alibaba (BABA) Tencent http://t.co/7VcChEIC5g (JD) are still growing revenue at 40% http://t.co/GQgE7weM3W,24,"['are', 'growing']",2,1,0,23,rubble,0
#360WiseNews : China's Stock Market Crash: Are There Gems In The Rubble? http://t.co/9Naw3QOQOL,19,['Are'],1,1,0,18,rubble,0
Jun 2015. Yemenis search for survivors under the rubble of houses in the old city of San├½Ôûê┬¼a following an... http://t.co/11JUzHlgmT,24,['following'],1,10,9,14,rubble,0
China's Stock Market Crash: Are There Gems In The Rubble? http://t.co/j4ggmKINEy #forbesasia,18,['Are'],1,1,0,17,rubble,0
Steve Buscemi was a firefightr B4 fame &amp; workd 12hr shifts diggin thru WTC rubble lookg 4 survivors. http://t.co/L9fJpNSZuO,24,"['was', 'diggin']",2,17,16,7,rubble,0
'Hiroshima never recovered and all the evidence was smothered under a thick cloud of rubble..' #jayElectronica,18,"['recovered', 'was', 'smothered']",3,15,14,3,rubble,0
#TNN: China's Stock Market Crash: Are There Gems In The Rubble? http://t.co/9LO0hZwJPZ,19,['Are'],1,1,0,18,rubble,0
China's Stock Market Crash: Are There Gems In The Rubble? http://t.co/BqBLWiw08g #ROIMentor #yycwalks,20,['Are'],1,1,0,19,rubble,0
While the world screams terrorism Assad buries civilians under the rubble of their homes. #Aleppo 05-08-2015 #Syria http://t.co/7GcPtCdx7o,23,['screams'],1,11,10,12,rubble,0
#360WiseNews : China's Stock Market Crash: Are There Gems In The Rubble? http://t.co/aOd2ftBMGU,19,['Are'],1,1,0,18,rubble,0
China's Stock Market Crash: Are There Gems In The Rubble? http://t.co/eKO50hD5Gz #market,18,['Are'],1,1,0,17,rubble,0
Four Things That May Ruin Your Personal Injury Accident Claim http://t.co/ZU9YYdF5DI,13,['ruin'],1,1,0,12,ruin,0
Watch This Airport Get Swallowed Up By A Sandstorm In Under A Minute http://t.co/mkWyvM3i8r,16,['Watch'],1,1,0,15,sandstorm,0
Watch This Airport Get Swallowed Up By A Sandstorm In Under A Minute http://t.co/aZL4XydvzK,16,['Watch'],1,1,0,15,sandstorm,0
Watch This Airport Get Swallowed Up By A Sandstorm In Under A Minute http://t.co/OFhjcn36o1,16,['Watch'],1,1,0,15,sandstorm,0
Watch This Airport Get Swallowed Up By A Sandstorm In Under A Minute http://t.co/Z2Ph0ArzYI,16,['Watch'],1,1,0,15,sandstorm,0
Watch This Airport Get Swallowed Up By A Sandstorm In Under A Minute http://t.co/nvSjHdGDGZ,16,['Watch'],1,1,0,15,sandstorm,0
Watch This Airport Get Swallowed Up By A Sandstorm In Under A Minute http://t.co/brctMNybjy,16,['Watch'],1,1,0,15,sandstorm,0
Watch This Airport Get Swallowed Up By A Sandstorm In Under A Minute http://t.co/NX2d83A4Du,16,['Watch'],1,1,0,15,sandstorm,0
Watch This Airport Get Swallowed Up By A Sandstorm In Under A Minute http://t.co/GaotrG4mTr,16,['Watch'],1,1,0,15,sandstorm,0
Watch This Airport Get Swallowed Up By A Sandstorm In Under A Minute http://t.co/rkU0IDM6aQ,16,['Watch'],1,1,0,15,sandstorm,0
Watch This Airport Get Swallowed Up By A Sandstorm In Under A Minute http://t.co/7IJlZ6BcSP,16,['Watch'],1,1,0,15,sandstorm,0
A sandstorm in Jordan has coated the Middle East├½Ôûê┬¼s largest refugee camp in a layer of grit http://t.co/hVJmuuaLXV http://t.co/T8Nz6h9Zz4,23,"['has', 'coated']",2,2,1,21,sandstorm,1
Watch This Airport Get Swallowed Up By A Sandstorm In Under A Minute http://t.co/YSrSKuyaSw,16,['Watch'],1,1,0,15,sandstorm,0
SANDSTORM!!! WOO HOO!!,8,['sandstorm'],1,1,0,7,sandstorm,0
Watch This Airport Get Swallowed Up By A Sandstorm In Under A Minute http://t.co/VZPKn23RX4,16,['Watch'],1,1,0,15,sandstorm,0
Watch This Airport Get Swallowed Up By A Sandstorm In Under A Minute http://t.co/Rm50vCVjsh,16,['Watch'],1,1,0,15,sandstorm,0
Watch This Airport Get Swallowed Up By A Sandstorm In Under A Minute http://t.co/1tr2KvXCTW,16,['Watch'],1,1,0,15,sandstorm,0
Watch This Airport Get Swallowed Up By A Sandstorm In Under A Minute http://t.co/Q0X7e84R4e,16,['Watch'],1,1,0,15,sandstorm,0
Watch This Airport Get Swallowed Up By A Sandstorm In Under A Minute http://t.co/ELDcP3vO7C,16,['Watch'],1,1,0,15,sandstorm,0
Watch This Airport Get Swallowed Up By A Sandstorm In Under A Minute http://t.co/H84R1TIh8J,16,['Watch'],1,1,0,15,sandstorm,0
Watch This Airport Get Swallowed Up By A Sandstorm In Under A Minute http://t.co/1oemJTO9Dp,16,['Watch'],1,1,0,15,sandstorm,0
Watch This Airport Get Swallowed Up By A Sandstorm In Under A Minute http://t.co/sEquWmvFx4,16,['Watch'],1,1,0,15,sandstorm,0
Watch This Airport Get Swallowed Up By A Sandstorm In Under A Minute http://t.co/akNyNPv461,16,['Watch'],1,1,0,15,sandstorm,0
Watch This Airport Get Swallowed Up By A Sandstorm In Under A Minute http://t.co/jqTMweDw33,16,['Watch'],1,1,0,15,sandstorm,0
Watch This Airport Get Swallowed Up By A Sandstorm In Under A Minute http://t.co/C9t2F6DLtM,16,['Watch'],1,1,0,15,sandstorm,0
Watch This Airport Get Swallowed Up By A Sandstorm In Under A Minute http://t.co/xSZicdWxq0,16,['Watch'],1,1,0,15,sandstorm,0
Watch This Airport Get Swallowed Up By A Sandstorm In Under A Minute http://t.co/Tr8YcHEFGQ,16,['Watch'],1,1,0,15,sandstorm,0
Watch This Airport Get Swallowed Up By A Sandstorm In Under A Minute http://t.co/1ZdRKTgogD,16,['Watch'],1,1,0,15,sandstorm,0
Watch This Airport Get Swallowed Up By A Sandstorm In Under A Minute http://t.co/TLcWeZPuKW,16,['Watch'],1,1,0,15,sandstorm,0
Watch This Airport Get Swallowed Up By A Sandstorm In Under A Minute http://t.co/qr6BtDCqCj,16,['Watch'],1,1,0,15,sandstorm,0
Watch This Airport Get Swallowed Up By A Sandstorm In Under A Minute http://t.co/wD9ODwjj9L,16,['Watch'],1,1,0,15,sandstorm,0
Watch This Airport Get Swallowed Up By A Sandstorm In Under A Minute http://t.co/87H5MbA3N1,16,['Watch'],1,1,0,15,sandstorm,0
Watch This Airport Get Swallowed Up By A Sandstorm In Under A Minute http://t.co/8L4RFFZD0P,16,['Watch'],1,1,0,15,sandstorm,0
Watch This Airport Get Swallowed Up By A Sandstorm In Under A Minute http://t.co/TvYQczGJdy,16,['Watch'],1,1,0,15,sandstorm,0
"Come out to Sandstorm tryouts Aug 15th at Lower Woodland!
MS Tryout: 3-4:30pm
HS Tryout: 4:30-6pm",19,['Come'],1,1,0,18,sandstorm,0
Watch This Airport Get Swallowed Up By A Sandstorm In Under A Minute http://t.co/BB7TTdVJWE,16,['Watch'],1,1,0,15,sandstorm,0
Watch This Airport Get Swallowed Up By A Sandstorm In Under A Minute http://t.co/Fkb7iUAuL8,16,['Watch'],1,1,0,15,sandstorm,0
Watch This Airport Get Swallowed Up By A Sandstorm In Under A Minute http://t.co/bgM4cSrbVd,16,['Watch'],1,1,0,15,sandstorm,0
@GodOf_Mischief_ -of Loki's daggers she pulled it out and jammed it into Mina's thigh. When Mina screamed and grabbed at her leg sif-,27,"['pulled', 'jammed', 'screamed', 'grabbed']",4,21,20,6,screamed,0
"OMFG??
Didnt expect Drag Me Down to be the first song Pandora played 

OMFG I SCREAMED SO LOUD
My coworker is scared http://t.co/VzcvAdkcQp",27,"['expect', 'be', 'played', 'is', 'scared']",5,1,0,26,screamed,0
Vacation update: my great aunt just killed a spider with her bare hand after I screamed in fear. #fierce,22,"['killed', 'screamed']",2,17,16,5,screamed,0
I JUST SCREAMED @toddyrockstar http://t.co/JDtPirnm76,8,['screamed'],1,1,0,7,screamed,0
@camilacabello97 Internally and externally screaming,6,['screaming'],1,6,5,0,screaming,0
"#NoChillLukeHammings
IM SCREAMING",4,['screaming'],1,1,0,3,screaming,0
"@LordMinion777 *screaming* i can't go!!!
:(",12,['go'],1,1,0,11,screaming,0
//screams in the distance// http://t.co/Cfe9HUQN0h,7,['screams'],1,1,0,6,screams,0
@OllyMursAus I do feel sorry for him! He is not a piece of meat! He is a nice guy... People don't need to rush him and screams in his face!,36,"['do', 'feel', 'sorry', 'is', 'is', 'do', 'need', 'rush']",8,32,31,4,screams,0
I agree with certain cultural appropriation things but honestly if u looked at my house it screams appropriation bc Buddhas and stuff-,22,"['agree', 'looked', 'screams']",3,17,16,5,screams,0
When you go to a concert and someone screams in your ear... Does it look like I wanna loose my hearing anytime soon???,28,"['go', 'Does', 'look', 'wan']",4,9,8,19,screams,0
The little girl next to me sees the spot lights in the sky and screams ' mom! Look I see Angels in the sky!' ????,31,"['sees', 'see']",2,15,14,16,screams,0
A subcontractor working for French seismic survey group CGG has been kidnapped in Cairo and is held by Islamic State the company said on W├½Ôûê_,25,"['working', 'has', 'been', 'kidnapped', 'is', 'held', 'said']",7,6,5,19,seismic,0
Oil and Gas Exploration http://t.co/PckF0nl2yN,7,['seismic'],1,1,0,6,seismic,0
SEISMIC RISK: a COMPARISON between 2 case studies: CALABRIA AND MALTA http://t.co/HmRtqEykyI,16,['seismic'],1,1,0,15,seismic,0
#Gabon : Oil and Gas Exploration Takes Seismic Shift in Gabon to Somalia http://t.co/SY8nqTLMD3 ^FJ http://t.co/yjDHoDdjox,21,['seismic'],1,1,0,20,seismic,0
"Anti-fracking group seeks review over #Lancashire seismic monitoring:
 
http://t.co/ZzbqmGNUsl #fracking http://t.co/Y23Xzl3fZv",18,"['seeks', 'fracking']",2,8,7,10,seismic,0
[10:45:27JST Aug06:First Alert] M4.1 at 'E off Chiba pref.' under 10km (35.8140.8). Estimated max seismic# is 3,28,"['Estimated', 'is']",2,25,24,3,seismic,0
Exploration takes seismic shift in #Gabon to #Somalia http://t.co/kLtIt88AS3,13,['takes'],1,3,2,10,seismic,0
The 08/06/2015 AlabamaQuake seismic summary w/ #earthquake #news &amp; history http://t.co/zM6VcZqvWk http://t.co/DKNlZNom6n,20,['seismic'],1,4,3,16,seismic,0
My brain feels like it's vibrating inside my skull. The MRI is going to look like a seismic readout of a faultline during earthquake season.,28,"[""'s"", 'vibrating', 'is', 'going', 'look']",5,20,19,8,seismic,0
#Sismo DETECTADO #JapÔòá_n [Report 1] 01:01:56 Okinawa Island region M4.0 Depth 10km Maximum seismic intensity 3 JST #??,24,['seismic'],1,18,17,6,seismic,0
#Fukushima still is not controlled &amp; #seismic retrofitting for other #reactors is a BIG issue @fukushima_actu http://t.co/lCDkTEOukj,25,"['is', 'controlled', 'is', 'fukushima_actu']",4,11,10,14,seismic,0
#Sismo DETECTADO #JapÔòá_n [Report 6] 01:02:42 Okinawa Island region M3.8 Depth 10km Maximum seismic intensity 3 JST #??,24,['seismic'],1,18,17,6,seismic,0
[Report 5] 18:22:45 Ibaraki Prefecture offing M5.5 Depth 60km Maximum seismic intensity 4 #Earthquake,17,['offing'],1,13,12,4,seismic,0
Oil and Gas Exploration Takes Seismic Shift in Gabon to Somalia - Bloomberg http://t.co/bEKrPjnYHs #??????? #Somalia,26,['seismic'],1,1,0,25,seismic,0
#Sismo DETECTADO #JapÔòá_n [Report 3] 01:02:17 Okinawa Island region M3.8 Depth 10km Maximum seismic intensity 3 JST #??,24,['seismic'],1,18,17,6,seismic,0
"Nuclear-Powered Brassiere Explodes During Seismic Survey http://t.co/76mKIdOOLh
 #Calgary #Edmonton #oilandgas #Vancouver #Toronto",19,['seismic'],1,1,0,18,seismic,0
#OilandGas Exploration Takes Seismic Shift in #Gabon to #Somalia http://t.co/oHHolJ9vEV via @business,18,['seismic'],1,1,0,17,seismic,0
"Exploration Takes Seismic Shift in #Gabon to #Somalia
http://t.co/Ltf6jL5keU http://t.co/Zlq8tHcTkW",16,['seismic'],1,1,0,15,seismic,0
Exploration takes seismic shift in Gabon to Somalia http://t.co/dmVR2H2fKM,11,['takes'],1,3,2,8,seismic,0
Panoramic Resources cuts jobs after seismic event http://t.co/mUwmfJGzYh,10,['seismic'],1,6,5,4,seismic,0
A subcontractor working for French seismic survey group CGG has been kidnapped in Cairo and is held by Islamic State the company said on W├½Ôûê_,25,"['working', 'has', 'been', 'kidnapped', 'is', 'held', 'said']",7,6,5,19,seismic,0
#Sismo DETECTADO #JapÔòá_n 06:32:43 Miyagi Estimated seismic intensity 0 JST #??,15,['seismic'],1,9,8,6,seismic,0
@Statoilasa &amp; @TOTAL make significant discovery in the North Sea: Visualise the full potential on our seismic     #g http://t.co/ve2eBqm21B,27,"['make', 'Visualise']",2,22,21,5,seismic,0
MRW when a sinkhole opens up beneath my friends and I... #gif #funny #lol #comedy #iFunny #video #image #RT http://t.co/XiYdYfptru,31,['opens'],1,4,3,27,sinkhole,0
http://t.co/OK9EBHurfl If your neighborhood school falls into a sinkhole State Sen. Steve Yarbrough may be close by...,20,"['falls', 'be']",2,11,10,9,sinkhole,0
Large sinkhole swallows entire pond in Lowndes County Georgia: Large sinkhole├½Ôûê_ http://t.co/bCLDQmMEHg #Occasion2B,17,['sinkhole'],1,12,11,5,sinkhole,0
10News ? Water main break disrupts trolley service http://t.co/pAug7a68i0,11,['sinkhole'],1,1,0,10,sinkhole,0
Some Evansville residents told to limit water usage due to sinkhole construction http://t.co/Lw6NeQJRoT,15,"['told', 'limit']",2,11,10,4,sinkhole,0
Sinkhole closes Falmer Drive in Bethlehem Township http://t.co/6TVVlG2fNi,10,['sinkhole'],1,1,0,9,sinkhole,0
A sinkhole grows in Brooklyn: six-meter crater swallows street http://t.co/gkPrvzQ6lk,13,['swallows'],1,2,1,11,sinkhole,1
Latest: USA: Huge sinkhole swallows up Brooklyn intersection http://t.co/vspKHg3nZy,13,['swallows'],1,6,5,7,sinkhole,1
Gaping sinkhole opens up in Brooklyn New York http://t.co/0xA6FCjyec,11,"['Gaping', 'opens']",2,2,1,9,sinkhole,1
├½Ôûê┬ñ@FDNY: This morning #FDNY responded to a sinkhole in #Brooklyn. Units remain on-scene with @NYCBuildings &amp; others. http://t.co/M78ir0IK01├½Ôûê├ÿ,30,"['responded', 'remain']",2,12,11,18,sinkhole,0
"150-Foot Sinkhole Opens in Lowndes County Residential Area
WCTV-35 minutes ago",11,['sinkhole'],1,1,0,10,sinkhole,1
Large sinkhole swallows entire pond in Lowndes County Georgia http://t.co/wKPzp1JCAu #YoNews,14,['sinkhole'],1,2,1,12,sinkhole,1
150-Foot Sinkhole Opens in Lowndes County Residential Area http://t.co/0YAxrJICRR,11,['sinkhole'],1,1,0,10,sinkhole,1
#SanDiego #News Sinkhole Disrupts Downtown Trolley Service: The incident happened Wed... http://t.co/RVMMuT3GvC #Algeria #???????,28,['happened'],1,1,0,27,sinkhole,0
beforeitsnews : A sinkhole grows in Brooklyn: six-meter crater swallows street ├½Ôûê_ http://t.co/QWo7q1AMh8) http://t.co/esRkmazEq9,20,['swallows'],1,4,3,16,sinkhole,0
Massive Sinkhole Emerges In Brooklyn http://t.co/n3Ow73Oasw http://t.co/Gs9bmplbHH,11,['sinkhole'],1,1,0,10,sinkhole,1
#LoMasVisto THOUSANDS OF HIPSTERS FEARED LOST: Giant Sinkhole Devours Brooklyn Intersectio... http://t.co/qwtk1b2fMC #CadenaDeSeguidores,19,['sinkhole'],1,1,0,18,sinkhole,0
A Sinkhole caved in a Brooklyn Street today on 5th Ave &amp; 64th Street. http://t.co/eUKhLKgGdO,20,['caved'],1,1,0,19,sinkhole,0
150-Foot Sinkhole Opens In Lowndes County Residential Area http://t.co/cBAxCuBA0h,11,['sinkhole'],1,1,0,10,sinkhole,0
Sinkhole Disrupts Downtown Trolley Service #SanDiego - http://t.co/9tb82ZMr2X,11,['sinkhole'],1,1,0,10,sinkhole,1
Sinkhole swallows Brooklyn intersection ├½Ôûê├è video http://t.co/1yBE5mgZL4 http://t.co/7Zog3DpdU9,12,['sinkhole'],1,1,0,11,sinkhole,1
"Sinkhole Selfies: You Wont Believe What's In The Brooklyn Sinkhole!: 
        Sinkhole Selfies: You Wont Belie... http://t.co/OFEbaKatNh",24,"['Wont', 'Believe', ""'s"", 'Wont']",4,1,0,23,sinkhole,0
Large sinkhole swallows entire pond in Lowndes County Georgia http://t.co/20Gi4Gyud5,12,['sinkhole'],1,2,1,10,sinkhole,0
Damn that sinkhole on sunset????,9,['sinkhole'],1,3,2,6,sinkhole,0
Water main break disrupts trolley service http://t.co/kff8ojrZP4 #sandiego http://t.co/JoB4GGtpAl,14,['sinkhole'],1,1,0,13,sinkhole,0
A sinkhole grows ... in Brooklyn? http://t.co/UiqKDdVwKz http://t.co/aa8FwtOHyJ,13,['sinkhole'],1,2,1,11,sinkhole,0
Giant Sinkhole Swallows NYC Intersection http://t.co/ozIZdsDWP4 via @NewsBeatSocial,11,['sinkhole'],1,1,0,10,sinkhole,0
A sinkhole grows in Brooklyn: six-meter crater swallows street http://t.co/LTLh53aRN4,13,['swallows'],1,2,1,11,sinkhole,1
Some Evansville residents told to limit water usage due to sinkhole construction: Some Evansville residents have├½Ôûê_ http://t.co/SJNyFszCu1,20,"['told', 'limit']",2,11,10,9,sinkhole,0
The sinkhole that ate Brooklyn http://t.co/28r2IgxmIE,8,['ate'],1,2,1,6,sinkhole,0
Sinkhole on west side damaging cars via @WEWS http://t.co/S7grbZNwlr,12,['damaging'],1,1,0,11,sinkhole,1
Georgia sinkhole closes road swallows whole pond http://t.co/cPEQv52LNA,10,['swallows'],1,2,1,8,sinkhole,1
"Sinkhole leaking sewage opens in housing estate
Irish Independent-3 Aug 2015",11,['leaking'],1,1,0,10,sinkhole,1
Watch This Giant Sinkhole Form on New York City Street http://t.co/BEnWu5IARa,13,['Watch'],1,1,0,12,sinkhole,0
#MTSAlert Orange &amp; Blue Line riders: Expect delays downtown due to a sinkhole that's developed in the vicinity of 4th &amp; C Street.,31,"['delays', 'downtown', ""'s"", 'developed']",4,17,16,14,sinkhole,0
There's a sinkhole in Brooklyn ?!,8,"[""'s""]",1,4,3,4,sinkhole,0
Share Large sinkhole swallows entire pond in Lowndes County Georgia A large├½Ôûê_ http://t.co/HvBJ30aj9s #YoNews,17,['sinkhole'],1,3,2,14,sinkhole,0
After a Few Years Afloat Pension Plans Start Sinking Again http://t.co/4cEEuzWHvf,13,['sinking'],1,1,0,12,sinking,0
that horrible sinking feeling when you├½Ôûê┬¼ve been at home on your phone for a while and you realise its been on 3G this whole time,25,"['been', 'realise', 'been']",3,3,2,22,sinking,0
"If you're lost and alone
Or you're sinking like a stone.
Carry on
May your past be the sound
Of your feet upon the ground",28,"[""'re"", 'lost', ""'re"", 'sinking', 'be']",5,10,9,18,sinking,0
4 equipment ego break upon dig your family internet hoke excepting versus a sinking term: dfLJEV,17,"['hoke', 'excepting']",2,14,13,3,sinking,0
"@AP 
 Too slow report the sinking boat in the Mediterranean sea what a shame",15,['sinking'],1,7,6,8,sinking,0
Do you feel like you are sinking in low self-image? Take the quiz: http://t.co/bJoJVM0pjX http://t.co/wHOc7LHb5F,21,"['Do', 'feel', 'are', 'sinking', 'Take']",5,7,6,14,sinking,0
that horrible sinking feeling when you├½Ôûê┬¼ve been at home on your phone for a while and you realise its been on 3G this whole time',26,"['been', 'realise', 'been']",3,3,2,23,sinking,0
That horrible sinking feeling when you├½Ôûê┬¼ve been at home on your phone for a while and you realise its been on 3G this whole time,25,"['been', 'realise', 'been']",3,3,2,22,sinking,0
The #Tribe just keeps sinking everyday it seems faster. As for this year it's been a titanic disaster.,22,"['keeps', 'sinking', 'seems', ""'s"", 'been']",5,6,5,16,sinking,0
that horrible sinking feeling when you├½Ôûê┬¼ve been at home on your phone for a while and you realise its been on 3G this whole time,25,"['been', 'realise', 'been']",3,3,2,22,sinking,0
'Amateur Night' Actress Reprises Role for 'Siren' - HorrorMovies.ca #horror http://t.co/W9Cd6OFfcj,16,['siren'],1,1,0,15,siren,0
There's a weird siren going off here...I hope Hunterston isn't in the process of blowing itself to smithereens...,23,"[""'s"", 'going', 'hope', 'is', 'blowing']",5,5,4,18,siren,0
@tomarse99 they all are intending to go. Just waiting for winds to drop. Siren just gone off to signal they allowed to leave arena.none gone,28,"['tomarse99', 'are', 'intending', 'go', 'waiting', 'drop', 'gone', 'signal', 'allowed', 'leave', 'gone']",11,1,0,27,siren,0
@Kronykal @B30wu1f2 I see no point in countering skewed statements. Dumb statement is dumb.,18,"['see', 'countering', 'is']",3,1,0,17,siren,0
The real question is why is the tornado siren going off in Dyersburg?,14,"['is', 'is', 'going']",3,9,8,5,siren,0
@SoonerMagic_ I mean I'm a fan but I don't need a girl sounding off like a damn siren,21,"['mean', ""'m"", 'do', 'need', 'sounding']",5,21,20,0,siren,0
Reasons I should have gone to Warped today: tony played issues showed up sleeping w sirens played attila is there issues issues issues,24,"['have', 'gone', 'showed', 'sleeping', 'played', 'is']",6,17,16,7,sirens,0
"Thu Aug 06 2015 01:20:32 GMT+0000 (UTC)
#millcityio #20150613
theramin sirens",15,['sirens'],1,15,14,0,sirens,0
my dad said I look thinner than usual but really im over here like http://t.co/bnwyGx6luh,17,"['said', 'look', 'im']",3,1,0,16,sirens,0
@KIRO7Seattle Just saw a Bomb Squad car heading north on Elliott with sirens on - any word on where they're headed??,25,"['saw', 'heading', ""'re"", 'headed']",4,14,13,11,sirens,0
I'm falling to pieces and I won't be whole until you let me in ? Heroine by Sleeping With Sirens ├½Ôûê├ï https://t.co/tQxLQUKq7z,26,"[""'m"", 'falling', 'be', 'let', 'Sleeping']",5,1,0,25,sirens,0
@TravelElixir Any idea what's going on? I hear no sirens but this damn helo is flying so low my apt is shaking!,26,"[""'s"", 'going', 'hear', 'is', 'flying', 'is', 'shaking']",7,13,12,13,sirens,0
I was walking past the fire house today &amp; as soon as I walk by the doors they get call and flip the sirens on. I've never ran so fast.,35,"['was', 'walking', 'walk', 'get', 'flip', ""'ve"", 'ran']",7,26,25,9,sirens,0
There was also a calm. Something was going to happen. Suddenly a crash of lightning came through the sky and with it the wails of sirens. --,30,"['was', 'was', 'going', 'happen', 'came']",5,28,27,2,sirens,0
Photoset: hakogaku: ?├òÔò®I am a kurd. i was born on a battlefield. raised on a battlefield. gunfire sirens... http://t.co/obp595W7tm,28,"['├òÔò®I', 'am', 'was', 'born', 'raised']",5,24,23,4,sirens,0
Hear the Sirens ?,4,['sirens'],1,1,0,3,sirens,0
"connor franta: damn sirens I hope everyone is okay. 

dan howell: can you PLEASE get MURDERED on ANOTHER STREET",22,"['hope', 'is', 'PLEASE', 'get']",4,5,4,17,sirens,0
Fire truck sirens for the past ten minutes straight coming and going. Must be huge. Maybe it's taco bell and they'll build a Sonic instead.,30,"['straight', 'coming', 'going', 'be', 'Maybe', ""'s"", 'build']",7,3,2,27,sirens,0
@wizkhalifa smoke ??so much you don't gotta do shit but light?? one of his locks on fire  ...that's like a whole tre five right there.,35,"['do', 'got', 'do', ""'s""]",4,3,2,32,smoke,0
@PianoHands You don't know because you don't smoke. The way to make taxis and buses come is to light a cigarette to smoke while you wait.,31,"['do', 'know', 'do', 'smoke', 'make', 'come', 'is', 'light', 'smoke', 'wait']",10,27,26,4,smoke,0
@BillMcCabe  sky looks clear.... No smoke from the fires. Enjoy your time in Tahoe. One of my favorite places!,25,"['looks', 'Enjoy']",2,9,8,16,smoke,0
I'm not asking no fee to smoke sumn if we ain't smoking out a ounce that's disrespectful,20,"[""'m"", 'asking', 'smoke', 'ai', 'smoking', ""'s""]",6,8,7,12,smoke,0
Send me flying off a cliff straight through the smoke of my spliff,13,"['Send', 'flying']",2,10,9,3,smoke,0
I get to smoke my shit in peace,8,"['get', 'smoke']",2,4,3,4,smoke,0
Manuel hoping for an early Buffalo snowstorm so his accuracy improves.,12,"['hoping', 'improves']",2,7,6,5,snowstorm,0
How does a snowstorm happen? Find the answers here: http://t.co/m75fCLUtF2 #snowstorm,16,['does'],1,16,15,0,snowstorm,0
you're my snowstorm baby ??,7,"[""'re""]",1,4,3,3,snowstorm,0
@Lily_Bell82 ya...summer is too short. Open toed shoes arent snowstorm friendly.,16,['is'],1,14,13,2,snowstorm,0
Sassy city girl country hunk stranded in Smoky Mountain snowstorm #AoMS http://t.co/nkKcTttsD9 #ibooklove #bookboost,19,['stranded'],1,10,9,9,snowstorm,0
It's creepy seeing 676 closed. It was closed during a snowstorm and my balcony overlooked the 676/76 overpass. Very eerie,23,"[""'s"", 'seeing', 'closed', 'was', 'closed', 'overlooked']",6,13,12,10,snowstorm,0
New #photo Oak in a snowstorm http://t.co/HK9Yf72OVA taken in #winter on the #SouthDowns #Hampshire #photography #art #tree #treeporn,28,['taken'],1,7,6,21,snowstorm,0
@Habbo bring back games from the past. Snowstorm. Tic tac toe. Battleships. Fast food. Matchwood.,22,['snowstorm'],1,1,0,21,snowstorm,0
RT RTphotographyUK: New #photo Oak in a snowstorm http://t.co/gWOKZELq5Q taken in #winter on the #SouthDowns #Hampshire #photography #art├½Ôûê_,27,['taken'],1,10,9,17,snowstorm,0
That organic freestyle with Casey veggies is cold as an ice cream cone in a Iceland snowstorm,17,['is'],1,17,16,0,snowstorm,0
"@dirk_trossen 

I've still got some of the snowstorm/hailstorm!",11,"[""'ve"", 'got']",2,10,9,1,snowstorm,0
"├½Ôûê┬ñ@LordBrathwaite: Everyone Here: Ahh I hate snow!

Me: Lol u call this a snowstorm..?

#growingupincolorado├½Ôûê├ÿ",23,"['hate', 'u', 'call']",3,20,19,3,snowstorm,0
@erincandy Hr/15 mins for me in that place. During a snowstormI was pissed lol We got oil delivered to them on snowmobiles in the end,27,"['was', 'pissed', 'got', 'delivered']",4,13,12,14,snowstorm,0
A snowstorm is brewing over my desk &amp; hands are NUMB.. @irishirr - I'm guessing you adjusted thermostat? :/ @WSAZ_Brittany @kellyannwx #WSAZ,31,"['is', 'brewing', 'are', ""'m"", 'guessing', 'adjusted', '@']",7,2,1,29,snowstorm,0
Long Island is technically the leftover dirt from a snowstorm and thats a geologic fact. That place is terrible.,21,"['is', 'thats', 'is']",3,10,9,11,snowstorm,0
#LakeEffect #Snowstorm Twill Denim Jackets   *** ALL MY PROCEEDS FOR ITEMS WITH THIS DESIGN WILL GO TO HELP THE... http://t.co/QmtDXuYktY,25,['snowstorm'],1,1,0,24,snowstorm,0
Transportation panel showing a video of a pileup of 18-wheelers in a snowstorm in WY. Crash crash crash ├½Ôûê┬ñMake it stop!├½Ôûê├ÿ #AMSsummer,26,"['showing', '├½Ôûê┬ñMake', 'stop']",3,13,12,13,snowstorm,1
Sassy city girl country hunk stranded in Smoky Mountain snowstorm #AoMS http://t.co/HDJS9RNtJ4 #ibooklove #bookboost,19,['stranded'],1,10,9,9,snowstorm,0
New #photo Oak in a snowstorm http://t.co/gWOKZELq5Q taken in #winter on the #SouthDowns #Hampshire #photography #art #tree #treeporn,28,['taken'],1,7,6,21,snowstorm,0
@PyrBliss ah I remember those days. In a snowstorm too.,13,['remember'],1,11,10,2,snowstorm,0
RT @WhistlerBlckcmb: One more #SnowBackSunday share: Snowstorm on the Glacier July 26 2015! via @momentumcamps http://t.co/JohKyMv9El,24,['snowstorm'],1,1,0,23,snowstorm,0
The sun is shining on this house now but imagine trying to build this summer home during a North East snowstorm!... http://t.co/BtJL9JkvXZ,26,"['is', 'shining', 'imagine', 'trying', 'build']",5,21,20,5,snowstorm,0
I liked a @YouTube video http://t.co/z8Cp77lVza Boeing 737 takeoff in snowstorm. HD cockpit view + ATC audio - Episode 18,24,['liked'],1,14,13,10,snowstorm,0
Photo: mothernaturenetwork: What is thundersnow? Hearing thunder during a snowstorm is extremely uncommon.... http://t.co/eYdAPauPvG,21,"['is', 'Hearing', 'is']",3,13,12,8,snowstorm,0
#LakeEffect #Snowstorm Twill Denim Jackets   *** ALL MY PROCEEDS FOR ITEMS WITH THIS DESIGN WILL GO├½Ôûê_ https://t.co/TxTpx4umqH,21,['snowstorm'],1,1,0,20,snowstorm,0
@PrablematicLA @Adweek I'm actually currently dressed for a snowstorm...despite being in the middle of a Texas summer. Thanks office A/C.,27,"[""'m"", 'dressed', 'being']",3,12,11,15,snowstorm,0
"I feel like the cold homeless orphan gazing into the cozy mansion of the affluent eating a lobster dinner during a snowstorm.

It's fine.",27,"['feel', 'gazing', 'eating', ""'s""]",4,22,21,5,snowstorm,0
Typhoon Soudelor was captured in this incredible NASA photo on it's way to Taiwan! http://t.co/dGGm5b0w4L http://t.co/eYr2Xx5l1p,22,"['was', 'captured', ""'s""]",3,1,0,21,storm,0
So this storm just came out of no where. .fuck me its cool,14,"['came', '.fuck']",2,3,2,11,storm,0
"How to prepare your #property for a #storm:

http://t.co/KhYqQsi6My http://t.co/G6Vs3XEinb",17,['prepare'],1,10,9,7,storm,0
Well this storm hit out of no where! ??,11,['hit'],1,3,2,8,storm,0
kesabaran membuahkan hasil indah pada saat tepat! life isn't about waiting for the storm to pass it's about learning to dance in the rain.,28,"['is', 'waiting', 'pass', ""'s"", 'learning', 'dance']",6,16,15,12,storm,0
@Jenniferarri_ comeeeee! ...but why is it bout to storm tho,13,"['is', 'storm']",2,12,11,1,storm,0
Is it bad to say that I'm kinda afraid of storms and we are in a storm???? help,23,"['Is', 'say', ""'m"", 'are']",4,18,17,5,storm,0
The Florence Regional Airport Director says no major damage at airport from yesterday's storm. No evacuations and no blown out windows.,24,"['says', 'blown']",2,15,14,9,storm,0
Looks like a perfect storm-free evening coming up.  Check out the outdoor happenings featured at http://t.co/hUzrHgmkSY #EventsPalmBeach.,22,"['coming', 'Check', 'featured']",3,5,4,17,storm,0
Crazy storm hit and I'm trapped inside a Hobby Lobby AMA http://t.co/8qc8Bcxoko,15,"[""'m""]",1,2,1,13,storm,0
Storm &amp; Family tonight http://t.co/0aP7MoNtjF,9,['tonight'],1,1,0,8,storm,0
What tropical storm? #guillermo by hawaiianpaddlesports http://t.co/LgPgAjgomY http://t.co/FKd1mBTB68,14,['storm'],1,3,2,11,storm,0
The Storm Prediction Center has expanded the 'Slight Risk' area to include more of central NC. #TWCNews #ncwx http://t.co/DgBeH5L9DS,25,"['has', 'expanded', 'include']",3,1,0,24,storm,0
'Calgarians stunned by storm insurance companies busy handling calls' #abstorm http://t.co/fkFa9vSssZ,15,"['stunned', 'handling']",2,4,3,11,storm,0
Ready for this storm,4,['storm'],1,4,3,0,storm,0
IGN: A Warcraft 3-inspired mode is likely coming to Heroes of the Storm http://t.co/2qVgImRo0R http://t.co/VTRoCiHSne,20,"['is', 'coming']",2,1,0,19,storm,0
Severe T-storm Warning for Union County ~3:45pm. Top threats include heavy rain lightning &amp; damaging winds. http://t.co/XWOevMK0aA,23,"['include', 'lightning', 'damaging']",3,1,0,22,storm,1
"NASAHurricane? EASTERN PACIFIC *Full Update* Satellite Sees Formation of Eastern Pacific's Tropical Storm Hilda
Th├½Ôûê_ http://t.co/KsXTo8NKNl",20,['storm'],1,1,0,19,storm,0
Storm rolling into Hilton Head gonna be fun,9,"['rolling', 'gon', 'be']",3,1,0,8,storm,0
#NASA announced that a massive #solar storm is headed straight for us: http://t.co/CM5u55MiOl,18,"['announced', 'is', 'headed']",3,9,8,9,storm,1
My last two weather pics from the storm on August 2nd. People packed up real fast after the temp dropped and winds picked up.,26,"['packed', 'dropped', 'picked']",3,8,7,18,storm,0
Doves - The Storm + Greatest Denier (Electric Proms Pt4) http://t.co/xjTpV4OydL,15,['storm'],1,1,0,14,storm,0
Today├½Ôûê┬¼s storm will pass; let tomorrow├½Ôûê┬¼s light greet you with a kiss. Bask in this loving warmth; let your soul return to bliss.,27,"['pass', 'let', 'tomorrow├½Ôûê┬¼s', 'let', 'bliss']",5,2,1,25,storm,0
├½Ôûê┬©Sexist├½Ôûê┬¼ peer review causes storm online https://t.co/WO2T0K4zXi via @timeshighered,12,"['peer', 'storm', 'timeshighered']",3,5,4,7,storm,0
Renewing Your Kitchen Cabinets for $100 http://t.co/lYs6p5BmDL http://t.co/ELfzsRGxRo,13,['Renewing'],1,1,0,12,stretcher,0
I was there to see @JimmieJohnson wreck in 2000 in person. My first thought was he's leaving on a stretcher!,24,"['was', 'see', 'was', ""'s"", 'leaving']",5,23,22,1,stretcher,0
Stretcher in 5 min https://t.co/DIWLBiaHvP,7,['stretcher'],1,1,0,6,stretcher,0
Keep shape your shoes ??#Amazon #foot #adjust #shape #shoe Mini Shoe Tree Stretcher Shaper Width Extender Adjustable http://t.co/8cPcz2xoHb,27,['Keep'],1,1,0,26,stretcher,0
Scary stuff in San Antonio. Stars head coach Dan Hughes was run into on the sidelines and fell over chairs onto the floor. Stretcher now out,28,"['head', 'was', 'run', 'fell']",4,1,0,27,stretcher,0
Throat stretcher http://t.co/vkThHbOQjs,5,['stretcher'],1,2,1,3,stretcher,0
@Stretcher @witter @Rexyy @Towel show me a picture of it,14,['show'],1,1,0,13,stretcher,0
1) 'Investigators say a Virgin Galactic spaceship crash was caused by structural failure after the co-pilot unlocked a braking system early',23,"['say', 'was', 'caused', 'unlocked']",4,1,0,22,structural failure,0
Investigators say a fatal Virgin Galactic spaceship crash last year was caused by structural failure after the... http://t.co/FoxpVpTttA,21,"['say', 'was', 'caused']",3,1,0,20,structural failure,0
SpaceX Founder Musk: Structural Failure Took Down Falcon 9 http://t.co/LvIzO9CSSR,13,['structural failure'],1,1,0,12,structural failure,0
Investigators say a fatal Virgin Galactic spaceship crash last year was caused by structural failure after the co-pilot unlocked a braking,21,"['say', 'was', 'caused', 'unlocked']",4,1,0,20,structural failure,0
Virgin galactic crash: early unlocking of brakes triggered structural failure http://t.co/Kp1hDchfNZ,14,['triggered'],1,1,0,13,structural failure,0
Investigators say a fatal Virgin Galactic spaceship crash last year was caused by structural failure after the... http://t.co/QOs0DE9BKQ,21,"['say', 'was', 'caused']",3,1,0,20,structural failure,0
Investigators rule catastrophic structural failure resulted in 2014 Virgin Galactic crash http://t.co/nLzbHcfXCM,14,"['rule', 'resulted']",2,1,0,13,structural failure,0
NTSB: Virgin Galactic crash caused by structural failure triggered when brakes unlocked early http://t.co/MgIG4uX7DM ├½Ôûê_,18,"['caused', 'triggered', 'unlocked']",3,1,0,17,structural failure,0
VIDEO: Virgin Galactic crash: Brakes blamed: Investigators have said a Virgin Galactic spaceship crash was caused by structural failure├½Ôûê_,22,"['blamed', 'have', 'said', 'was', 'caused']",5,1,0,21,structural failure,0
Investigators have said a Virgin Galactic spaceship crash was caused by structural failure after the co-pilot ... http://t.co/imAWVMzs3A,20,"['have', 'said', 'was', 'caused']",4,1,0,19,structural failure,0
Investigators say a fatal Virgin Galactic spaceship crash last year was caused by structural failure after the... http://t.co/FPrt7NwrOt,21,"['say', 'was', 'caused']",3,1,0,20,structural failure,0
Building structural integrity &amp; failure: problems inspections damages defects testing repair | Rightways https://t.co/a1KN4U3YuA,19,"['Building', 'testing']",2,1,0,18,structural failure,0
The result of failure in correcting structural problems with West's financial markets collapse https://t.co/DvieABlOFz,17,"['correcting', 'collapse']",2,1,0,16,structural failure,0
Virgin galactic crash: early unlocking of brakes triggered structural failure - Irish Examiner http://t.co/ocMCvfDZkv,17,['triggered'],1,1,0,16,structural failure,0
Investigators say a fatal Virgin Galactic spaceship crash last year was caused by structural failure after the co├½Ôûê_,18,"['say', 'was', 'caused']",3,1,0,17,structural failure,0
Rightways: Building structural integrity &amp; failure: inspections damages defects testing  repair http://t.co/vz1irH0Nmm via @rightwaystan,21,['testing'],1,1,0,20,structural failure,0
Virgin galactic crash: early unlocking of brakes triggered structural failure http://t.co/3YLSQ1fSEf http://t.co/ABpMLymHNK,17,['triggered'],1,1,0,16,structural failure,0
Investigators say a fatal Virgin Galactic spaceship crash last year was caused by structural failure after the... http://t.co/SYL7ou7qVW,21,"['say', 'was', 'caused']",3,1,0,20,structural failure,0
NTSB: Virgin Galactic's SpaceshipTwo crash due to structural failure when braking system unlocked early http://t.co/EYSbLYX6L6 via @KPCC @AP,24,['unlocked'],1,1,0,23,structural failure,0
├½Ôûê┬ñ@NewsHour: Investigators rule catastrophic structural failure resulted in 2014 Virgin Galactic crash http://t.co/M8HRetrO31├½Ôûê├ÿ,18,"['rule', 'resulted']",2,1,0,17,structural failure,0
Investigators have said a Virgin Galactic spaceship crash was caused by structural failure after the co-pilot ... http://t.co/PnhPLJHo8E,20,"['have', 'said', 'was', 'caused']",4,1,0,19,structural failure,0
Investigators rule catastrophic structural failure resulted in 2014 ... http://t.co/AdZ8kbuRt7,12,"['rule', 'resulted']",2,1,0,11,structural failure,0
The NTSB reports that last year's crash of a Virgin Galactic spaceship was caused by structural failure after the ├½Ôûê_ http://t.co/vSAPkWJTEA,24,"['was', 'caused']",2,1,0,23,structural failure,0
Investigators have said a Virgin Galactic spaceship crash was caused by structural failure after the co-pilot ... http://t.co/WC69XAJIs4,20,"['have', 'said', 'was', 'caused']",4,1,0,19,structural failure,0
Investigators have said a Virgin Galactic spaceship crash was caused by structural failure after the co-pilot unlocked a braking system,20,"['have', 'said', 'was', 'caused', 'unlocked']",5,1,0,19,structural failure,0
#BBCLive Investigators say a fatal Virgin Galactic spaceship crash last year was caused by structural failure ...  http://t.co/u5suyvLfZJ,21,"['say', 'was', 'caused']",3,1,0,20,structural failure,0
Slums are a manifestation state failure to provide housing to citizens. Illegality discourse confounds structural problems. #stopevictions,20,"['are', 'provide']",2,1,0,19,structural failure,0
Investigators say a fatal Virgin Galactic spaceship crash last year was caused by structural failure after the...  http://t.co/BgRAb7lK8D,21,"['say', 'was', 'caused']",3,1,0,20,structural failure,0
"'Jet fuel cant melt steel'
'The structural failure is illogical'
'The second plane crashing into the building is fake'
'It was a bomb'",24,"['melt', 'is', 'crashing', 'is', 'was']",5,1,0,23,structural failure,0
Investigators rule catastrophic structural failure resulted in 2014 ... http://t.co/QU1IUg3E9r,12,"['rule', 'resulted']",2,1,0,11,structural failure,0
Virgin galactic crash: early unlocking of brakes triggered structural failure: The crash of a Virgin Galactic ... http://t.co/x3VqxdouVT,22,['triggered'],1,1,0,21,structural failure,0
Investigators rule catastrophic structural failure resulted in 2014 Virg.. Related Articles: http://t.co/Cy1LFeNyV8,15,"['rule', 'resulted']",2,1,0,14,structural failure,0
NTSB: Virgin Galactic crash caused by structural failure triggered when brakes unlocked early http://t.co/iKnyOk9zZr http://t.co/QCKqcX4Hw9,20,"['caused', 'triggered', 'unlocked']",3,1,0,19,structural failure,0
Investigators say a fatal Virgin Galactic spaceship crash last year was caused by structural failure after the co-pilot unlocked a braking,21,"['say', 'was', 'caused', 'unlocked']",4,1,0,20,structural failure,0
International News ├½Ôûê├│├òÔò®'Nigeria suicide bomb kills at least seven at market ' via @233liveOnline. Full story at http://t.co/MtTdvy6141,22,['suicide bomb'],1,1,0,21,suicide bomb,0
#Bestnaijamade: 16yr old PKK suicide bomber who detonated bomb in ... http://t.co/KSAwlYuX02 bestnaijamade bestnaijamade bestnaijamade be├½Ôûê_,20,"['detonated', 'bestnaijamade']",2,1,0,19,suicide bomb,0
Pic of 16yr old PKK suicide bomber who detonated bomb in Turkey Army trench released http://t.co/1yB8SiZarG http://t.co/69iIzvyQYC,21,"['detonated', 'released']",2,1,0,20,suicide bomb,0
Pic of 16yr old PKK suicide bomber who detonated bomb in Turkey Army trench released http://t.co/uWfvWMjepU http://t.co/pxONlrqUsm,21,"['detonated', 'released']",2,1,0,20,suicide bomb,0
#Bestnaijamade: 16yr old PKK suicide bomber who detonated bomb in ... http://t.co/KSAwlYuX02 bestnaijamade bestnaijamade bestnaijamade be├½Ôûê_,20,"['detonated', 'bestnaijamade']",2,1,0,19,suicide bomb,0
@AlfaPedia It might have come out ONLY too burst as a Bomb making him suicide bomber,17,"['have', 'come', 'making']",3,1,0,16,suicide bomb,0
Pic of 16yr old PKK suicide bomber who detonated bomb in Turkey Army trench released http://t.co/pOL92mn8YZ,18,"['detonated', 'released']",2,1,0,17,suicide bomb,0
...//..// whao.. Pic of 16yr old PKK suicide bomber who detonated bomb in Turkey Army trench released http://t.co/tuVbR4lEP3,21,"['detonated', 'released']",2,1,0,20,suicide bomb,0
Look at the previous battles. Citizens were committing suicide so to not be under American control. The bomb was the only way. @NBCNews,27,"['were', 'committing', 'be', 'was']",4,1,0,26,suicide bomb,0
Pic of 16yr old PKK suicide bomber who detonated bomb in Turkey Army trench released http://t.co/VtVXa0Srmw http://t.co/Qq70Gf99ba,21,"['detonated', 'released']",2,1,0,20,suicide bomb,0
reaad/ plsss Pic of 16yr old PKK suicide bomber who detonated bomb in Turkey Army trench released,17,"['detonated', 'released']",2,1,0,16,suicide bomb,0
#Bestnaijamade: 16yr old PKK suicide bomber who detonated bomb in ... http://t.co/KSAwlYuX02 bestnaijamade bestnaijamade bestnaijamade be├½Ôûê_,20,"['detonated', 'bestnaijamade']",2,1,0,19,suicide bomb,0
reaad/ plsss Pic of 16yr old PKK suicide bomber who detonated bomb in Turkey Army trench released,17,"['detonated', 'released']",2,1,0,16,suicide bomb,0
Pic of 16yr old PKK suicide bomber who detonated bomb in Turkey Army trench released http://t.co/IUh718KCy0 http://t.co/9pQyx4xOOL,21,"['detonated', 'released']",2,1,0,20,suicide bomb,0
See the 16yr old PKK suicide bomber who detonated bomb in Turkey Army trench├½Ôûê_ http://t.co/ZdiEodWbog via @MsOreo_ http://t.co/V6nyLVdPeD,23,"['See', 'detonated']",2,1,0,22,suicide bomb,0
//./../.. Pic of 16yr old PKK suicide bomber who detonated bomb in Turkey Army trench released http://t.co/Sj57BoKsiB -/,20,"['detonated', 'released']",2,1,0,19,suicide bomb,0
#Bestnaijamade: 16yr old PKK suicide bomber who detonated bomb in ... http://t.co/KSAwlYuX02 bestnaijamade bestnaijamade bestnaijamade be├½Ôûê_,20,"['detonated', 'bestnaijamade']",2,1,0,19,suicide bomb,0
#Bestnaijamade: 16yr old PKK suicide bomber who detonated bomb in ... http://t.co/KSAwlYuX02 bestnaijamade bestnaijamade bestnaijamade be├½Ôûê_,20,"['detonated', 'bestnaijamade']",2,1,0,19,suicide bomb,0
ll//ll= Pic of 16yr old PKK suicide bomber who detonated bomb in Turkey Army trench released http://t.co/8vBgg9IY7i /,20,"['detonated', 'released']",2,1,0,19,suicide bomb,0
//./../.. Pic of 16yr old PKK suicide bomber who detonated bomb in Turkey Army trench released http://t.co/fqSk7QCawO -/,20,"['detonated', 'released']",2,1,0,19,suicide bomb,0
./.....hmm Pic of 16yr old PKK suicide bomber who detonated bomb in Turkey Army trench released http://t.co/5v29w19tFX /(,23,"['detonated', 'released']",2,1,0,22,suicide bomb,0
recap/ Pic of 16yr old PKK suicide bomber who detonated bomb in Turkey Army trench released http://t.co/6jzCEdaYRG,19,"['detonated', 'released']",2,1,0,18,suicide bomb,0
11 soldiers killed in ISIS suicide bomb in air base east Homs SYRIA NEWS | ZAMAN ALWSL  - http://t.co/V8juC5eK1A  #ISIS #Homs,25,['killed'],1,1,0,24,suicide bomb,0
16yr old PKK suicide bomber who detonated bomb in Turkey Army trench released http://t.co/mGZslZz1wF,16,"['detonated', 'released']",2,1,0,15,suicide bomb,0
16yr old PKK suicide bomber who detonated bomb in Turkey Army trench released http://t.co/5orTB8p51c,16,"['detonated', 'released']",2,1,0,15,suicide bomb,0
wo Pic of 16yr old PKK suicide bomber who detonated bomb in Turkey Army trench released http://t.co/Sj57BoKsiB /'/'//,20,"['detonated', 'released']",2,1,0,19,suicide bomb,0
16yr old PKK suicide bomber who detonated bomb in Turkey Army trench released http://t.co/n7Yst76ku3,16,"['detonated', 'released']",2,1,0,15,suicide bomb,0
Pic of 16yr old PKK suicide bomber who detonated bomb in Turkey Army trench released http://t.co/gnynJHnE6j http://t.co/1fuNEMes7M,21,"['detonated', 'released']",2,1,0,20,suicide bomb,0
Pic of 16yr old PKK suicide bomber who detonated bomb in Turkey Army trench released: Harun Ôòá├ôekdar a member o... http://t.co/v0NTQyZlPK,25,"['detonated', 'released', 'Ôòá├ôekdar']",3,1,0,24,suicide bomb,0
wo Pic of 16yr old PKK suicide bomber who detonated bomb in Turkey Army trench released http://t.co/5v29w19tFX /'/'//,20,"['detonated', 'released']",2,1,0,19,suicide bomb,0
International News ├½Ôûê├│├òÔò®'Nigeria suicide bomb kills at least seven at market ' via @233liveOnline. Full story at http://t.co/MtTdvy6141,22,['suicide bomb'],1,1,0,21,suicide bomb,0
Pic of 16yr old PKK suicide bomber who detonated bomb in Turkey Army trench released http://t.co/FVXHoPdf3W,18,"['detonated', 'released']",2,1,0,17,suicide bomb,0
#Bestnaijamade: 16yr old PKK suicide bomber who detonated bomb in ... http://t.co/KSAwlYuX02 bestnaijamade bestnaijamade bestnaijamade be├½Ôûê_,20,"['detonated', 'bestnaijamade']",2,1,0,19,suicide bomb,0
Iraq - Hashd Shaabi Theft ISIS Suicide Car bomb http://t.co/2AG9auABr3 #ISIS http://t.co/Qna4TUBnWh,17,['suicide bomb'],1,1,0,16,suicide bomb,0
ll//ll= Pic of 16yr old PKK suicide bomber who detonated bomb in Turkey Army trench released http://t.co/uoNEbAHH3h /,20,"['detonated', 'released']",2,1,0,19,suicide bomb,0
16yr old PKK suicide bomber who detonated bomb in Turkey Army trench released http://t.co/mMkLapX2ok,16,"['detonated', 'released']",2,1,0,15,suicide bomb,0
#GRupdates Pic of 16yr old PKK suicide bomber who detonated bomb in Turkey Army trench released --&gt;... http://t.co/P5yASKTq0K,25,"['detonated', 'released']",2,1,0,24,suicide bomb,0
#GRupdates Pic of 16yr old PKK suicide bomber who detonated bomb in Turkey Army trench released --&gt; http://t.co/fqcDPhccg7,24,"['detonated', 'released']",2,1,0,23,suicide bomb,0
#Bestnaijamade: 16yr old PKK suicide bomber who detonated bomb in ... http://t.co/KSAwlYuX02 bestnaijamade bestnaijamade bestnaijamade be├½Ôûê_,20,"['detonated', 'bestnaijamade']",2,1,0,19,suicide bomb,0
Pic of 16yr old PKK suicide bomber who detonated bomb in Turkey Army trench released http://t.co/I3ceSn7KXI http://t.co/2yCM0dlQ2f,21,"['detonated', 'released']",2,1,0,20,suicide bomb,0
? 19th Day Since 17-Jul-2015 -- Nigeria: Suicide Bomb Attacks Killed 64 People; Blamed: Boko Haram [L.A. Times/AP] | http://t.co/O2cdKpSDfp,27,"['Killed', 'Blamed']",2,1,0,26,suicide bomb,0
#Bestnaijamade: 16yr old PKK suicide bomber who detonated bomb in ... http://t.co/KSAwlYuX02 bestnaijamade bestnaijamade bestnaijamade be├½Ôûê_,20,"['detonated', 'bestnaijamade']",2,1,0,19,suicide bomb,0
16yr old boy pic PKK suicide bomber who detonated bomb in Turkey Army trench http://t.co/H3SXfV5mtC http://t.co/IEWDreNauK,20,['detonated'],1,1,0,19,suicide bomb,0
Pic of 16yr old PKK suicide bomber who detonated bomb in Turkey Army trench released: Harun Ôòá├ôekdar a member o... http://t.co/fMoqK26hIm,25,"['detonated', 'released', 'Ôòá├ôekdar']",3,1,0,24,suicide bomb,0
New post: Pic of 16yr old PKK suicide bomber who detonated bomb in Turkey Army trench released http://t.co/LWDcrPEhTN,21,"['detonated', 'released']",2,1,0,20,suicide bomb,0
Suicide bomber kills 15 in Saudi security site mosque http://t.co/ETyZY8GB2A #mercados,14,['suicide bomber'],1,1,0,13,suicide bomber,0
Suicide Bomber Kills 13 At Saudi Mosque http://t.co/oZ1DS3Xu0D #Saudi #Tripoli #Libya,16,['suicide bomber'],1,1,0,15,suicide bomber,0
Six people were killed Thursday when a Taliban suicide bomber detonated an explosives-rigged truck outside a police compound in eastern,20,"['were', 'killed', 'detonated']",3,1,0,19,suicide bomber,0
ISIS claims responsibility for Saudi mosque suicide bombing http://t.co/Wpilp4mymf http://t.co/8NHD9iDaJs,14,"['claims', 'bombing']",2,1,0,13,suicide bomber,0
Suicide bomber kills 15 in Saudi security site mosque http://t.co/AxhcLfErSU,12,['suicide bomber'],1,1,0,11,suicide bomber,1
#Noticias Suicide bomber kills 15 in Saudi security site mosque  http://t.co/oipt1uBaXo,14,['kills'],1,1,0,13,suicide bomber,1
#ISIS claims responsibility for Saudi suicide bombing  http://t.co/jlMICJ6jE5,11,"['claims', 'bombing']",2,1,0,10,suicide bomber,1
Islamic State claims suicide bombing at Saudi Arabian mosque: Ten members of emergency service... http://t.co/mpOaEFQl6k via @josephjett,22,['bombing'],1,1,0,21,suicide bomber,0
Suicide Bomber Kills 13 At Saudi Mosque: Back in May a suicide bomber struck a Shi'ite mosque in eastern Saud.. http://t.co/FlrOvkANC0,24,['struck'],1,1,0,23,suicide bomber,1
#saudiarabia 13 confirmed dead as suicide bomber attacks Saudi Arabian mosque - The I... http://t.co/LwAnE9vupg - http://t.co/CpQguFZB28,23,"['saudiarabia', 'confirmed']",2,1,0,22,suicide bomber,0
Suicide bomber kills 15 in Saudi security site mosque http://t.co/1I62JjK6pT,12,['suicide bomber'],1,1,0,11,suicide bomber,1
"qtSZg mhtw4fnet

Suicide bomber kills 15 in Saudi security site mosque - Reuters",13,['kills'],1,1,0,12,suicide bomber,0
Suicide bomber kills 15 in Saudi security site mosque - Reuters Canada: Reuters CanadaSuicide bomber kills 15 ... http://t.co/Ktd5IG9M5o,22,['suicide bomber'],1,1,0,21,suicide bomber,1
Suicide bomber kills at least 15 in Saudi mosque: A suicide bomb attack inside a mosque in a local security fo... http://t.co/n6njdG6r9l,26,['suicide bomber'],1,1,0,25,suicide bomber,1
Suicide bomber kills 15 in Saudi security site mosque http://t.co/YyTKP1Z5kG via @Reuters,15,['suicide bomber'],1,1,0,14,suicide bomber,1
News: 'Islamic State claims suicide bombing at Saudi Arabian mosque' http://t.co/vIJfNHl630,15,['bombing'],1,1,0,14,suicide bomber,0
New post: Suicide Bomber Kills 13 At Saudi Mosque http://t.co/YcuV4KTgrl,13,['suicide bomber'],1,1,0,12,suicide bomber,1
"17 killed in S├½Ôûê┬¼Arabia mosque suicide bombing

A suicide bomber attacked a mosque in Aseer south-western Saudi... http://t.co/pMTQhiVsXX",21,"['killed', 'bombing', 'attacked']",3,1,0,20,suicide bomber,0
Suicide bomber detonates in Saudi Arabia mosque 17 reportedly killed http://t.co/BNVCvNYXXj,13,"['mosque', 'killed']",2,1,0,12,suicide bomber,0
Mosque bombing strikes Saudi special forces; at least 15 people dead: A suicide bomber struck a mosque i... http://t.co/gigW51IZpK #news,26,"['bombing', 'struck']",2,1,0,25,suicide bomber,0
Suicide bomber 'hits Saudi mosque' http://t.co/kE6DjxAnmm,9,['suicide bomber'],1,1,0,8,suicide bomber,1
Suicide Bomber Kills 13 At Saudi Mosque http://t.co/VHQeD0gO0n,10,['suicide bomber'],1,1,0,9,suicide bomber,1
Suicide bomber detonates in Saudi Arabia mosque 17 reportedly killed  http://t.co/xycKgxZv9s,13,"['mosque', 'killed']",2,1,0,12,suicide bomber,0
Suicide bomber kills 15 in Saudi Arabia mosque used by the police :IS claims responsible for barbarism http://t.co/Ux5YA1cSG3,21,['used'],1,1,0,20,suicide bomber,1
Suicide bomber kills 15 in Saudi security site mosque - A suicide bomber killed at least 15 people in an attack on... http://t.co/FY0r9o7Xsl,26,['killed'],1,1,0,25,suicide bomber,1
@ZeeNews How come no one asked the obvious QN? Why show a Hindu suicide bomber?  Never heard of one.,23,"['come', 'asked', 'show']",3,1,0,22,suicide bomber,0
More details: Bomber kills at least 13 at #Saudi mosque in Asir - including 10+ members of 'special emergency forces' http://t.co/i1626mnNd9,26,['including'],1,1,0,25,suicide bomber,1
Suicide bomber kills 15 in Saudi security site mosque - Reuters http://t.co/37DqvJHNCv,14,['http'],1,1,0,13,suicide bomber,1
Suicide bomber kills 15 in Saudi security site mosque - Reuters http://t.co/KCObrZBVDs http://t.co/y62HSFVIAQ,17,['http'],1,1,0,16,suicide bomber,1
#?? #?? #??? #??? Suicide bomber kills 15 in Saudi security site mosque - Reuters  http://t.co/LgpNe5HkaO,28,['http'],1,1,0,27,suicide bomber,1
"@Abu_Baraa1 Suicide bomber targets Saudi mosque at least 13 dead - Suicide bomber targets Saudi mosque at least 13 dead
This is ridiculous",24,['is'],1,1,0,23,suicide bomber,1
http://t.co/9k1tqsAarM Suicide bomber kills 15 in Saudi security site mosque - Reuters http://t.co/Ev3nX9scx3,17,['http'],1,1,0,16,suicide bomber,1
#deai #??? #??? #??? Suicide bomber kills 15 in Saudi security site mosque - Reuters  http://t.co/SqydkslFzp,28,['http'],1,1,0,27,suicide bomber,1
Suicide Bomber Kills More Than a Dozen in Saudi Mosque: Saudi Arabia have started experiencing some terrorist ... http://t.co/PIoY1O54f4,22,"['have', 'started', 'experiencing']",3,1,0,21,suicide bomber,0
[The Guardian] Islamic State claims suicide bombing at Saudi Arabian mosque http://t.co/tqvPUSaFJQ,16,['bombing'],1,1,0,15,suicide bomber,0
Suicide Bomber Kills 13 At Saudi├òÔò®Mosque http://t.co/h99bHB29xt,9,['suicide bomber'],1,1,0,8,suicide bomber,1
Google News CA: Suicide bomber kills 15 in Saudi security site mosque - Reuters: Wall Street Jou... http://t.co/mawD20REGb #News #Canada,27,['kills'],1,1,0,26,suicide bomber,1
Suicide bomber kills 15 in Saudi security site mosque http://t.co/axK9XNo6Yz #mercados,14,['suicide bomber'],1,1,0,13,suicide bomber,1
IS claims suicide bombing against Saudi police: An Islamic State group suicide bomber on Thursday detonated an... http://t.co/Dn5Buo7GSK,22,"['IS', 'bombing', 'suicide', 'detonated']",4,1,0,21,suicide bomber,0
@bbclaurak Why is no one talking about the risk of a suicide bomber hiding amongst the migrants stowing aboard the Eurotunnel  trains?,24,"['is', 'talking', 'hiding', 'stowing']",4,1,0,23,suicide bomber,0
IS claims suicide bombing against Saudi police: RIYADH (AFP) - An Islamic State group suicide bomber on Thursd... http://t.co/IBypE1kaz5,25,"['IS', 'bombing', 'suicide']",3,1,0,24,suicide bomber,0
#?? #?? #??? #??? Suicide bomber kills 15 in Saudi security site mosque - Reuters  http://t.co/ebGGmfxoBy,28,['http'],1,1,0,27,suicide bomber,1
Suicide Bomber Kills More Than a Dozen in Saudi Mosque: Saudi Arabia have started experiencing some terrorist ... http://t.co/GuAJ2t910b,22,"['have', 'started', 'experiencing']",3,1,0,21,suicide bomber,0
Islamic State claims suicide bombing at Saudi Arabian mosque: Ten members of emergency services... http://t.co/0Bznfdg0aR #Kabari #World,23,['bombing'],1,1,0,22,suicide bomber,0
Suicide bomber kills 15 in Saudi security site mosque  #world #news,13,['suicide bomber'],1,1,0,12,suicide bomber,1
'Islamic State' group claims Saudi mosque suicide blast: The jihadist group claims it sent a suicide bomber to├½Ôûê_ http://t.co/H2CTpG4oyZ #dw,25,"['claims', 'sent']",2,1,0,24,suicide bomber,0
17 dead as suicide bomber attacks Saudi Arabian mosque http://t.co/d5cUDwuhww | https://t.co/twnsWk0hFJ,16,['suicide bomber'],1,1,0,15,suicide bomber,1
IS claims suicide bombing against Saudi police: An Islamic State group suicide bomber on Thursday detona... http://t.co/yoXZFbRvzI #news,23,"['IS', 'bombing', 'suicide']",3,1,0,22,suicide bomber,0
#?? #?? #??? #??? Suicide bomber kills 15 in Saudi security site mosque - Reuters  http://t.co/txg7K2DO9v,28,['http'],1,1,0,27,suicide bomber,1
I was taught at school in the 1970s that piracy slavery and suicide-bombing were purely historical. No one then expected them to re-occur,24,"['was', 'taught', 'piracy', 'were', 'expected', 're-occur']",6,1,0,23,suicide bombing,0
After a suicide bombing in SuruÔòá├▒ that killed 32 people Turkey launches airstrikes against ISIL and Kurdistan Workers' Party camps in Iraq.,24,"['killed', 'launches']",2,1,0,23,suicide bombing,1
@daisycuttertz @GROGParty @Tony_Burke He's been having lessons in suicide bombing from his imam!,18,"[""'s"", 'been', 'having']",3,1,0,17,suicide bombing,0
@sonofbobBOB @Shimmyfab @trickxie usually I'd agree. Once the whole chopping heads off throwing gays off rooftops &amp; suicide bombing start,27,"['agree', 'throwing', 'bombing']",3,1,0,26,suicide bombing,0
"Suicide bombing for Da'esh is (rightly) despicable. Suicide bombing for Ocalan/ Marxism?

= They share 'our values'. https://t.co/Gs0km0vlgk",26,"['bombing', 'is', 'bombing']",3,1,0,25,suicide bombing,0
AFP: #PKK said it carried out suicide bombing against troops in eastern #Turkey as a reprisal for 'bombing of a civilian village',26,"['said', 'carried', 'bombing', ""'bombing""]",4,1,0,25,suicide bombing,0
"Erdogan├½Ôûê┬¼s Bloody Gambit: 
Max Zirngast in Jacobin:
On July 20 a suicide bombing took the lives of thirty-one... http://t.co/l1vN8zXLGG",24,"['bombing', 'took']",2,1,0,23,suicide bombing,0
@samfbiddle If Gawker so badly wants to commit suicide why don't you just volunteer your offices to test the new F35's bombing capabilities.,27,"['wants', 'commit', 'do', 'volunteer', 'test']",5,1,0,26,suicide bombing,0
#ISIS claims credit for suicide bombing 'with 6 tons of explosives' at the central command of #Syria(n) T4 airbase http://t.co/QOaU2QLJ3B,28,"['claims', 'bombing']",2,1,0,27,suicide bombing,0
&lt; 25 Dead In Kuwait Mosque Suicide Bombing Claimed By ISIS Offshoot on http://t.co/eTITgPSrUN,18,['suicide bombing'],1,1,0,17,suicide bombing,1
IF SUICIDE BOMBING WASTHE SMARTEST THING2 DO FOR ALLAH/GODJESUS/THE HOLY PROPHET MUHAMMAD COULD HAVE KILLEDSOMEBODY? http://t.co/tGfWuVVHxj,19,['suicide bombing'],1,1,0,18,suicide bombing,0
Kurdish Militants Target Turkish Military In Suicide Attack - Huffington Post http://t.co/03bJm4ORoW,14,['Target'],1,1,0,13,suicide bombing,0
Suicide bombing is just the fear of dying alone,9,"['is', 'dying']",2,1,0,8,suicide bombing,0
'Suicide bombing at [location named]...' #premonitions http://t.co/iIkSsJGBDn,14,"['bombing', 'named']",2,1,0,13,suicide bombing,0
@JewhadiTM It is almost amazing to think someone thought suicide bombing would actually be a good idea.,19,"['is', 'think', 'thought', 'bombing', 'be']",5,1,0,18,suicide bombing,0
13 security personnel killed in Iraq suicide bombing | http://t.co/IbAZRHlSUr http://t.co/B6wWq2nYQI,15,"['killed', 'bombing']",2,1,0,14,suicide bombing,1
Turkish troops killed in Kurdish militant 'suicide attack' http://t.co/wD7s6S0vci,12,['killed'],1,1,0,11,suicide bombing,1
Remembering Rebecca Roga 40 of the Philippines. murdered by Hamas terrorists in the suicide bombing of Egged bus No. 361,22,"['Remembering', 'murdered']",2,1,0,21,suicide bombing,0
INFOGRAPHIC: At least 20 Turkish security officials killed in PKK and ISIS terror attacks since Suruc suicide bombing http://t.co/UvAOJzcYcZ,22,"['killed', 'suicide', 'bombing']",3,1,0,21,suicide bombing,1
@PieroCastellano @nipped suicide bombing civilians in major TR cities yet?,13,"['nipped', 'suicide', 'bombing']",3,1,0,12,suicide bombing,0
Remembering Sgt.-Maj. Roni Ghanem 28 of Maghar murdered by Hamas terrorists in the suicide bombing of Egged bus No. 361 13 years ago today,25,"['Remembering', 'murdered']",2,1,0,24,suicide bombing,0
Malik Saadthe best police officer produced by KPdied in a suicide bombing on 27 Jan 2007he was more than a brother to me. #KPPolice.,27,"['produced', 'was']",2,1,0,26,suicide bombing,0
bout to go suicide bombing http://t.co/ZoIPkPBD6o,8,"['go', 'bombing']",2,1,0,7,suicide bombing,0
&lt; Suicide Bombing Of European Union Car Kills At Least Three In Kabul on http://t.co/o6aRmcgVbS,19,['suicide bombing'],1,1,0,18,suicide bombing,1
@RayquazaErk There are Christian terrorists to be sure but I don't suicide bombing is employed often as it is in Islamic groups.,25,"['are', 'be', 'do', 'suicide', 'is', 'employed', 'is']",7,1,0,24,suicide bombing,0
Turkish troops killed in Kurdish militant 'suicide attack' http://t.co/nVP6wrKL1E,12,['killed'],1,1,0,11,suicide bombing,1
Turkish troops killed in Kurdish militant 'suicide attack' http://t.co/7cIbxls55f,12,['killed'],1,1,0,11,suicide bombing,1
Alleged driver in #Kuwait attack 'joined Daesh just a day before the June 26 suicide bombing' he confesses in court http://t.co/Tmz6X1N2gQ,25,"['Alleged', ""'joined"", 'bombing', 'confesses']",4,1,0,24,suicide bombing,0
@Haji_Hunter762 @MiddleEastEye maybe some muzzies will spontaneously combust! It's like Allah suicide bombing them as payback ????????,28,"['combust', ""'s"", 'suicide', 'bombing']",4,1,0,27,suicide bombing,0
The number of security officials killed by PKK in terror attacks since the Suruc suicide bombing has reached 22 https://t.co/OpJwuNUvG8,22,"['killed', 'has', 'reached']",3,1,0,21,suicide bombing,0
Turkish troops killed in Kurdish militant 'suicide attack' http://t.co/q1eIXnjjpt,12,['killed'],1,1,0,11,suicide bombing,1
'Suicide bombing at [location named]...' #premonitions http://t.co/iIkSsJGBDn,14,"['bombing', 'named']",2,1,0,13,suicide bombing,1
Erdogan's Bloody Gambit: on July 20 a suicide bombing in Turkey took the lives of 31 socialists in SuruÔòá├▒ http://t.co/z6xAUIDRXu @Shareaholic,26,['took'],1,1,0,25,suicide bombing,0
PKK Suicide Bombing Kills 2 Soldiers in Turkey http://t.co/dfanUDwSQ3,11,['suicide bombing'],1,1,0,10,suicide bombing,1
YAOUNDE Cameroon (AP) ├½Ôûê├ï Authorities have ordered the closure of mosques and Islamic schools following a series of suicide bombing attacks,23,"['have', 'ordered', 'following']",3,1,0,22,suicide bombing,0
Kurd Suicide Attack Kills 2 Turkish Soldiers http://t.co/GHGHQm9e6d,10,['suicide bombing'],1,1,0,9,suicide bombing,1
@NBCPolitics RUSSIA AND THAT BACK FIRED NOW 2015 look what happened 911bombing of marine barracks  suicide bombers attacks on world sites,22,"['happened', 'suicide']",2,1,0,21,suicide bombing,0
"Imagine a school where suicide bombing Is being taught the teachers would say to the students...

'Please pay... http://t.co/zfiVVxYDZY",23,"['Imagine', 'Is', 'being', 'taught', 'say']",5,1,0,22,suicide bombing,0
Turkish troops killed in Kurdish militant 'suicide attack' http://t.co/7old5MJWph,12,['killed'],1,1,0,11,suicide bombing,1
#ISIL has claimed credit for three suicide bombing attacks targeting regime checkpoints on the outskirts of Al-Qaryatayn. #Homs #Syria,23,"['has', 'claimed', 'bombing', 'targeting']",4,1,0,22,suicide bombing,0
9) 'Without the bombing you would have to do hara-kiri you know commit suicide'. http://t.co/UO0aQk9KR8 Hiroshima 70 years ago.,25,"['have', 'do', 'hara-kiri', 'know']",4,1,0,24,suicide bombing,0
Remembering Mordechai Yehuda Friedman 24 of Ramat Beit Shemesh; murdered by Hamas terrorists in the suicide bombing of Egged bus No. 361,24,"['Remembering', 'murdered']",2,1,0,23,suicide bombing,0
Remembering Marlene Menahem 22 of Moshav Safsufa;  murdered by Hamas terrorists in the suicide bombing of Egged bus No. 361,22,"['Remembering', 'murdered']",2,1,0,21,suicide bombing,0
1 of the major reason of suicide bombing is the absence of sexual interactions.,15,['is'],1,1,0,14,suicide bombing,0
MUST-SEE: Massive ISIS Suicide Truck Bombing Caught On Tape http://t.co/hMsPYpozLn via @GabbyOgbechie1TPGazette,16,['suicide bombing'],1,1,0,15,suicide bombing,1
why wasn't this warship sunk?      CNN: First on CNN: Iranian warship points weapon at U.S. helicopter official says http://t.co/hfZk09McEN,25,"['was', 'weapon', 'says']",3,6,5,19,sunk,1
British diver Neil Anthony Fears found dead by the wreck of a steamship - Daily Mail http://t.co/QP3GVvfoFq,19,['found'],1,1,0,18,sunk,0
Near them on the sand half sunk a shattered visage lies... http://t.co/0kCCG1BT06,15,['sunk'],1,7,6,8,sunk,1
Aquarium Ornament Wreck Sailing Boat Sunk Ship Destroyer Fish Tank Cave Decor - Full read ├½Ôûê_ http://t.co/kNCm9jC8i9 http://t.co/swviAZSPHk,22,['read'],1,1,0,21,sunk,0
Japan FUSO Class Battleship YAMASHIRO Naval Cover 1999 PHOTO Cachet SUNK WWII http://t.co/Aq5ZliM7l4 http://t.co/FvR9jDQ71a,18,['sunk'],1,1,0,17,sunk,0
Today 5/8/1941 Today 1941 British cargo ship Kumasian torpedoed/sunk Atlantic lost 1 of 60 lives Any1 have link? #crewlist #WW2,23,"['lost', 'have', 'link']",3,1,0,22,sunk,1
@SaintRobinho86 someone has to be at the bottom of every league. Tonight clearly demonstrated why the Lions are where they are - sunk!,26,"['has', 'be', 'demonstrated', 'are', 'are']",5,25,24,1,sunk,0
Aquarium Ornament Wreck Sailing Boat Sunk Ship Destroyer Fish Tank Cave Decor - Full read ├½Ôûê_ http://t.co/nosA8JJjiN http://t.co/WUKvdavUJu,22,['read'],1,1,0,21,sunk,0
The Seven Seas - Wreck of the Giannis D. sunk after hitting a submerged reef in the├½Ôûê_ http://t.co/Gn3WHNSFIb http://t.co/fWpOF5TwoC,23,['hitting'],1,10,9,13,sunk,0
So much shit has happened today wtf idk how I survive thruuu it all,14,"['has', 'happened', 'survive']",3,11,10,3,survive,0
A country Chim can survive!,6,['survive'],1,5,4,1,survive,0
I Will Survive by Gloria Gaynor (with Oktaviana Devi) ├½Ôûê├ï https://t.co/HUkJZ1wT36,15,"['Survive', '├½Ôûê├ï']",2,1,0,14,survive,0
"Escaping her captors was the 1st step. Now she must survive a deadly storm &amp; a wild-looking recluse.
BETRAYED
http://t.co/0Q040STkCV
#books",28,"['Escaping', 'was', 'survive']",3,12,11,16,survive,0
#WWII #SGM T34 in flames but with tank of gasoline to the outside it is likely that the crew survive . http://t.co/Psz22ky0fM,26,['is'],1,22,21,4,survive,0
#Autoinsurance industry clueless on driverless cars : #healthinsurance http://t.co/YdEtWgRibk,13,['survive'],1,1,0,12,survive,0
"Update: I survived. No canoe. 

May have been the fastest feed out in history though.",19,"['survived', 'have', 'been']",3,4,3,15,survived,1
Meet the man who survived both Hiroshima and Nagasaki http://t.co/PNSsIa5e46 http://t.co/LSVsYSpdxX,15,['survived'],1,5,4,10,survived,0
"Grandma's friends survived to the attack in Hiroshima but they died with cancer when kids/teenagers??
#BombEffects",20,"['survived', 'died']",2,4,3,16,survived,0
It's a miracle that mankind survived 70 years since one of the worst days in its history. All bets are off if it will survive the next 70.,31,"[""'s"", 'mankind', 'survived', 'are', 'survive']",5,7,6,24,survived,0
Good news Adam Barton survived the helicopter crash in #Emmerdale maybe now he can start training &amp; get match fit. #Pompey,26,"['survived', 'start', 'get']",3,5,4,21,survived,0
@TheSmallClark 'He'll kill me instead if he survived the shot. I don't exactly know. I fled the scene and pulled the trigger with---,30,"['kill', 'survived', 'do', 'know', 'fled', 'pulled']",6,10,9,20,survived,0
@rjkrraj @KarnakaranK @vimvith whether pressure or not NON wud not survived even if thalapathi didn't release,20,"['vimvith', 'wud', 'survived', 'did', 'release']",5,14,13,6,survived,0
The 390-Year-Old Tree That Survived the Bombing of Hiroshima http://t.co/kEirA8MA3K,12,['Survived'],1,1,0,11,survived,0
'Planted 390 years ago' it was moved to U-S. This Bonsai Survived Hiroshima But Its Story Was Nearly Lost http://t.co/jID4RO34gb via @NatGeo,27,"[""'Planted"", ""'"", 'was', 'moved', 'Lost']",5,1,0,26,survived,0
Only one man Tsutomi Yamaguchi is said to have survived both atomic bomb blasts at #Hiroshima and #Nagasaki. #OTD http://t.co/DaalPeNZp0,26,"['is', 'said', 'have', 'survived']",4,10,9,16,survived,0
Well said Sir. My cousin was a POW. Brutally treated. Survived but never talked about it. The bombing was justified https://t.co/SuDkK1wEEZ,27,"['said', 'was', 'treated', 'Survived', 'talked', 'was']",6,1,0,26,survived,0
RT THR 'RT THRArchives: 1928: When Leo the MGM Lion Survived a Plane Crash #TBT http://t.co/Wpkl2qNiQW http://t.co/BD52FxDvhQ',25,['Survived'],1,1,0,24,survived,0
Trapped a bee in my shoe only one of us survived I just ran 0.15 mi @ a 13'46'' pace with Nike+. http://t.co/IbG4ynJsw8 #nikeplus,29,"['Trapped', 'survived', 'ran', '@']",4,11,10,18,survived,0
├½Ôûê┬ñ@BBCWomansHour: Setsuko Thurlow survived the #Hiroshima bomb. This is her story: http://t.co/cvjYML7KrM http://t.co/FpH01U3eIi├½Ôûê├ÿ,23,"['survived', 'is']",2,7,6,16,survived,0
Important piece on long-term #health effects of #Hiroshima by @juliepower: http://t.co/J2s4Ng7wGt via @smh @croakeyblog,22,['smh'],1,1,0,21,survivors,0
The Cafe Run by Acid Attack Survivors in #India http://t.co/qmiF0bLwOa http://t.co/l6PIf3LpEn,16,['survivors'],1,1,0,15,survivors,0
Haunting memories drawn by survivors http://t.co/a4H2e5xhiK via CNN,10,"['Haunting', 'drawn']",2,5,4,5,survivors,0
Hiroshima survivors fight nuclear industry in Brazil Ôòá├│?? video http://t.co/GLZmGBM7w0,14,['fight'],1,2,1,12,survivors,0
"Tricycle toddler atomic bomb
http://t.co/ljeRYHItwh In a fraction of a second Our decisions change the landscape of humanity.",21,['change'],1,1,0,20,survivors,0
The Cafe Run by Acid Attack Survivors in #India http://t.co/XtVRJMRREs http://t.co/ndvlAPJvQL,16,['survivors'],1,1,0,15,survivors,0
CNN: Haunting memories drawn by survivors http://t.co/ZEnDvsgYMD,10,['drawn'],1,7,6,3,survivors,0
Patient-reported outcomes in long-term survivors of metastatic colorectal cancer - British Journal of Surgery http://t.co/5Yl4DC1Tqt,17,['survivors'],1,5,4,12,survivors,0
Dear @POTUS In the name of humanityI apologized to #Hiroshima Survivors.R u ready to do so?#Japan #nuclearweapons http://t.co/TWykzN4rlC,26,"['apologized', 'do']",2,1,0,25,survivors,0
#coppednews Haunting memories drawn by survivors http://t.co/Wx11d69gEZ,10,"['Haunting', 'drawn']",2,7,6,3,survivors,0
"RT @kotowsa: South Sudan├½Ôûê┬¼s war on women: survivors say rape has become 'just a normal thing' 
https://t.co/MexwoHd3TG http://t.co/gB46FiD2wE",26,"['say', 'has', 'become']",3,11,10,15,survivors,0
Haunting memories drawn by survivors http://t.co/pRAro2OWia,8,"['Haunting', 'drawn']",2,5,4,3,survivors,0
Hiroshima survivors fight nuclear industry in Brazil ├½Ôûê├è video http://t.co/E7SHtYLbnL,12,['fight'],1,2,1,10,survivors,0
Aya Kano├½Ôûê┬¼s family has taken two nuclear hits: First #Hiroshima. Then #Fukushima. http://t.co/kcx9w2EJ8A http://t.co/aC50jw3Xmw,23,"['has', 'taken']",2,1,0,22,survivors,0
See the comment from @yogal700 on @thejournal_ie:LÔòá├Á Niamh leads search for survivors of capsized migrant boat.... http://t.co/TAKgauQ6pd,25,"['See', 'leads']",2,16,15,9,survivors,0
"#WorldNews
 Fears over missing migrants in Med - BBC News - Home:
Rescuers search for survivors after a boat carr.. http://t.co/iJoBZ3MZp0",25,"['missing', 'search']",2,18,17,7,survivors,0
#orlando Survivors of Shanghai Ghetto reunite after 70 years http://t.co/f8pE52ZeyX,13,['survivors'],1,1,0,12,survivors,0
As Anniversary Nears Atomic Bomb Survivors Speak Out Against Nuclear Power | Common Dreams  http://t.co/n8f2dXVduD,17,['survivors'],1,1,0,16,survivors,0
Breaking news: Haunting memories drawn by survivors http://t.co/PCjBvrs7xw,11,"['Breaking', 'drawn']",2,8,7,3,survivors,0
Haunting memories drawn by survivors http://t.co/kDh4evYWpt via cnnbrk CNN #news,13,"['Haunting', 'drawn']",2,5,4,8,survivors,0
As Anniversary Nears Atomic Bomb Survivors Speak Out Against Nuclear Power - http://t.co/Uo8GrDAuAT,15,['survivors'],1,1,0,14,survivors,0
Hiroshima survivors fight nuclear industry in Brazil ├½Ôûê├è video http://t.co/uvM975yha2,12,['fight'],1,2,1,10,survivors,0
The second part which focuses on the survivors is really difficult to watch but at the same time is really powerful.,22,"['focuses', 'is', 'watch', 'is']",4,8,7,14,survivors,0
"RT @SyedIHusain @penelopephoto 
The man who survived Hiroshima: 'I had entered a living hell on earth' http://t.co/qFinwD7ls7",24,"['penelopephoto', 'survived', 'had', 'entered']",4,1,0,23,survivors,0
@Arovolturi3000 survived because of magic  she is searching the wood for survivors outside of London,16,"['survived', 'is', 'searching']",3,13,12,3,survivors,1
No text is worth your life. Hear stories of survivors and pledge not to text and drive. http://t.co/xkAfgsGmZ5,22,"['is', 'text', 'drive']",3,11,10,11,survivors,0
@TheNerdsofColor @GeorgeTakei narrates our new doc about #Hiroshima WWII bombing and survivors tales. Check it out http://t.co/33RfRc7ZqT,23,"['narrates', 'Check']",2,15,14,8,survivors,0
@ShaunKing Check this out: Tribute to survivors of sexual assault by law enforcement officers on facebook.,19,['ShaunKing'],1,9,8,10,survivors,0
@FedPorn I feel your pain. Survivors will look back on this period as most absurd in human history. Satire indistinguishable from reality.,26,"['feel', 'look']",2,1,0,25,survivors,0
├½Ôûê┬©Faceless body belonged to my sister├½Ôûê┬¼: #Hiroshima #Nagasaki #nuke survivors recall horrors 70 years on ├½Ôûê├ï RT News http://t.co/918EQmTkrL,25,"['belonged', 'recall']",2,14,13,11,survivors,0
Hiroshima schoolgirls archive memories of A-bomb horror http://t.co/32IzXXrUdP via @ABCNews,13,['schoolgirls'],1,1,0,12,survivors,0
@LawfulSurvivor T-Dog had been holed up in an apartment store with several other survivors Glenn Morales Andrea Jacqui and Merle.--,22,"['had', 'been', 'holed']",3,15,14,7,survivors,0
Stemming from my #Cubs talk- the team rosters 2 cancer survivors in @ARizzo44 &amp; @JLester34...@Cubs fans: help another http://t.co/XGnjgLE9eQ,30,"['Stemming', 'rosters']",2,12,11,18,survivors,0
Haunting memories drawn by survivors http://t.co/WJ7UjFs8Fd,8,"['Haunting', 'drawn']",2,5,4,3,survivors,0
Remembrance  http://t.co/ii4EwE1QIr #Hiroshima http://t.co/H3vUsqzyQo,9,['survivors'],1,1,0,8,survivors,0
"Cross-border terrorism: Pakistan caught red-handed again
http://t.co/FfbnLuiy0f via@timesofindia",13,['caught'],1,2,1,11,terrorism,0
News786-UK Islamist Cleric Anjem Choudary Charged Under Terrorism Act: http://t.co/u7bBeNXWYK,13,['terrorism'],1,1,0,12,terrorism,0
A Brief History of False Flag Terrorism | Wake Up World - http://t.co/KTeqJRXzpc via http://t.co/yZxlQeMKPF,19,['terrorism'],1,1,0,18,terrorism,0
"Truth...
https://t.co/nXS3Z1kxiD
#News
#BBC
#CNN
#Islam
#Truth
#god
#ISIS
#terrorism
#Quran
#Lies http://t.co/UDKMAdKuzY",28,['Lies'],1,21,20,7,terrorism,0
Preacher faces UK terrorism charges http://t.co/daPlllFuqK,8,"['faces', 'http']",2,4,3,4,terrorism,0
Woman sneaks into airplane cockpit; terrorism not suspected http://t.co/1W58Ehv9S1 http://t.co/p8Ih0hni3l,15,"['sneaks', 'suspected']",2,7,6,8,terrorism,1
NC Senate follows House on legal action on terrorism damages - Winston http://t.co/2Y5MoRpugt,15,['follows'],1,9,8,6,terrorism,0
#Politics Democracy├½Ôûê┬¼s hatred for hate: ├½Ôûê_ Dawabsha threaten to erode Israeli democracy. Homegrown terrorism ha...  http://t.co/q8n5Tn8WME,22,"['hatred', 'erode']",2,17,16,5,terrorism,0
Cross-border terrorism: Pakistan caught red-handed again http://t.co/uDj50J3MV4,10,['caught'],1,2,1,8,terrorism,0
CTD arrest three vital criminals from Orangi: KARACHI: Counter-Terrorism Department (CTD) of the Sindh Police ... http://t.co/Le4brduau9,23,['terrorism'],1,1,0,22,terrorism,1
Still domestic terrorism  https://t.co/GevRMBVznB,6,['terrorism'],1,3,2,3,terrorism,0
DireTube Information ├½Ôûê├è Egypt Cyprus and Greece agreed to fight├òÔò®terrorism http://t.co/V6IjxCCD2I http://t.co/YSXhFWMGOD,16,"['agreed', 'fight├òÔò®terrorism']",2,1,0,15,terrorism,0
"Truth...
https://t.co/GLzggDjQeH
#News
#BBC
#CNN
#Islam
#Truth
#god
#ISIS
#terrorism
#Quran
#Lies http://t.co/MYtCbJ6nmh",28,['Lies'],1,21,20,7,terrorism,0
Combating #fear of #terrorismturn off your tv &amp;Veterans For Peace Calls 4 an End 2 #NATO #VFP http://t.co/YPPG4kZIpS http://t.co/cBfdI6LF2X,30,"['Combating', 'terrorismturn']",2,6,5,24,terrorism,0
Cross-border terrorism: Pakistan caught red-handed again http://t.co/NVGNF9AcuU,10,['caught'],1,2,1,8,terrorism,0
Perspectives on Terrorism - Understanding Jihadi Proto-States: http://t.co/d5h4jif1y3,11,['Understanding'],1,1,0,10,terrorism,0
DHS Refuses to Call Chattanooga ├½Ôûê┬©Islamic Terrorism├½Ôûê┬¼ out of respect for MUSLIMS ... http://t.co/u8RGB51d22 via @po_st http://t.co/2tnu95VGFE,22,"['Refuses', 'Call']",2,1,0,21,terrorism,0
Pakistan's Supreme Court rules to allow military trials for suspects in terrorism cases http://t.co/ajpbdCalew,17,"['allow', 'http']",2,13,12,4,terrorism,0
A good piece on Israeli incitement and Jewish terrorism by Beinart: http://t.co/OT2OOOEdts,15,['terrorism'],1,9,8,6,terrorism,0
In #islam saving a person is equal in reward to saving all humans! Islam is the opposite of terrorism!,22,"['saving', 'is', 'saving', 'is']",4,21,20,1,terrorism,0
New US counter #terrorism program urges #Muslims to rat each other out critics say http://t.co/r0w85x3b0z http://t.co/VUUQqBo6mp,22,"['rat', 'say']",2,5,4,17,terrorism,0
@AdamNibloe Arrest report: Affiliation with Terrorism,8,['terrorism'],1,1,0,7,terrorism,0
People buyout over terrorism and Isis but have a better chance getting shot at in a movie theater  https://t.co/jkdjH2zw8s,21,"['buyout', 'have', 'getting']",3,4,3,17,terrorism,0
Cross-border terrorism: Pakistan caught red-handed again @timesofindia http://t.co/ZfdcWV4ch0,12,['caught'],1,2,1,10,terrorism,0
"?? Iran largest sponsor of terrorism
?? If #IranDeal goes thru US gives $150 Billion

?? FACT: US will become largest supporter of terrorism",30,"['goes', 'thru', 'gives', 'become']",4,30,29,0,terrorism,0
"Truth...
https://t.co/2Y4RGob7pj
#News
#BBC
#CNN
#Islam
#Truth
#god
#ISIS
#terrorism
#Quran
#Lies http://t.co/mVes6VsSyN",28,['Lies'],1,21,20,7,terrorism,0
Really cannot condemn an entire group based on the actions of a few.. A heart-warming unity against terrorism.. http://t.co/HHPvPaEL4n,22,"['condemn', 'based']",2,19,18,3,terrorism,0
"Truth...
https://t.co/p5ZIcjUdXO
#News
#BBC
#CNN
#Islam
#Truth
#god
#ISIS
#terrorism
#Quran
#Lies http://t.co/kZhB8zX6YC",28,['Lies'],1,21,20,7,terrorism,0
@Daggy1 Maybe reagan giving weapons to Iran's regime in the 1980s is terrorism no?,17,"['reagan', 'giving', 'is']",3,15,14,2,terrorism,0
@KurtSchlichter  He's already done it by negotiating with the #1 state of terrorism in the World. What was his hurry in trying to get a deal,30,"[""'s"", 'done', 'negotiating', 'was', 'trying', 'get']",6,16,15,14,terrorism,0
"Truth...
https://t.co/n1K5nlib9X
#News
#BBC
#CNN
#Islam
#Truth
#god
#ISIS
#terrorism
#Quran
#Lies http://t.co/CGz84MUOCZ",28,['Lies'],1,21,20,7,terrorism,0
Pakistan Supreme Court endorses military courts for terrorism cases http://t.co/sZeapuEuvy,12,"['endorses', 'http']",2,8,7,4,terrorism,0
"Truth...
https://t.co/4ZQrsAQrRT
#News
#BBC
#CNN
#Islam
#Truth
#god
#ISIS
#terrorism
#Quran
#Lies http://t.co/6ar3UKvsxw",28,['Lies'],1,21,20,7,terrorism,0
Cross-border terrorism: Pakistan caught red-handed again - The Times of India http://t.co/uiqsfgZoOx,15,['caught'],1,2,1,13,terrorism,0
Captured terrorist Naved not registered as our citizen: Pakistan http://t.co/0FS9kSV5xK,13,['registered'],1,2,1,11,terrorist,0
Terrorist attack in #Udhampur district in J&amp;K; 2 SPOs injured,16,['injured'],1,1,0,15,terrorist,1
Signing a petition to seek mercy on a death punishment for a convivted terrorist is a job well done in India. But asking a foreign govt 1/n,28,"['Signing', 'seek', 'is', 'done', 'asking']",5,14,13,14,terrorist,0
Udhampur terror attack: NIA takes over probe Pakistani terrorist quizzed; Pak denies link  http://t.co/i3gLzABeGl,18,"['takes', 'quizzed', 'denies', 'link']",4,10,9,8,terrorist,0
Three Israeli soldiers wounded in West Bank terrorist attack - Haaretz http://t.co/Mwd1iPMoWT #world,16,['wounded'],1,8,7,8,terrorist,1
Here├½Ôûê┬¼s how media in Pakistan covered the capture of terrorist Mohammed Naved http://t.co/3MtWh0jJns,15,['covered'],1,10,9,5,terrorist,0
Update on Pulwama encounter that began earlier today: 2nd terrorist killed by security forces. Security forces...  http://t.co/m5RjekVDDp,22,"['began', 'killed']",2,11,10,11,terrorist,1
Fresh encounter in Pulwama of J&amp;amp;K one terrorist killed others holed up inside a house http://t.co/oEf123l5Rc,24,"['killed', 'holed']",2,14,13,10,terrorist,1
'The Terrorist Tried to Get Out of the Car; I Shot Him' http://t.co/VSoxKbt6Nq,17,"['Get', 'Shot']",2,1,0,16,terrorist,1
Me pulling over and fighting the hoes that called Zayn a terrorist  http://t.co/FY30fV0Qbx,15,"['fighting', 'called']",2,12,11,3,terrorist,0
Udhampur terror attack: NIA takes over probe Pakistani terrorist quizzed; Pak denies link  http://t.co/ogZJOkd7Sv  #Elections #AcheDin #├½Ôûê_,24,"['takes', 'quizzed', 'denies', 'link']",4,10,9,14,terrorist,0
@narendramodi @bjpsamvad Hiroshima is now beautiful on the ashes of the old. So could be a terrorist Pakistan.,22,"['is', 'be']",2,20,19,2,terrorist,0
@rahulkanwal why  Jammu is soft target for terrorist,9,['is'],1,9,8,0,terrorist,0
Anyone missing their license plate? Two stolen ones found on terrorist's car... http://t.co/CWGCciw3V6,18,"['missing', 'found']",2,12,11,6,terrorist,1
Pakistan Disowned Kasab Now Disowns Naved: State of Denial?: Naved the terrorist captured alive after an├½Ôûê_ http://t.co/HGDrK81sN4,22,"['Disowned', 'Disowns', 'Naved', 'Naved', 'captured']",5,15,14,7,terrorist,0
The Pak terrorist who has been caught alive must be tried fast not delayed as KasabWe must send very hard message to Pak instead of Biryani,26,"['has', 'been', 'caught', 'be', 'tried', 'delayed', 'send']",7,3,2,23,terrorist,0
RT AbbsWinston: #Zionist #Terrorist kidnapped 15 #Palestinians in overnight terror on Palestinian Villages ├½Ôûê_ http://t.co/J5mKcbKcov,21,['kidnapped'],1,1,0,20,terrorist,0
Reading rec today: Faisal Devji's Terrorist in Search of Humanity on extremists using idea ever since the bomb of humanity as single entity,25,"['Reading', 'using']",2,1,0,24,terrorist,0
@VICE no sympathyONLF is a terrorist group affiliated with AL shabab This is war! Go report on  war crimes committed by Western powers!,26,"['is', 'affiliated', 'is', 'committed']",4,7,6,19,terrorist,0
"RT AbbsWinston: #Zionist #Terrorist Demolish Tire Repair Shop Structure in #Bethlehem
http://t.co/ph2xLI8nVe http://t.co/22fuxHn7El",21,['terrorist'],1,1,0,20,terrorist,1
To whom we shld ask tht from where this bldy PAK terrorist has entered in our country...?,19,"['shld', 'has', 'entered']",3,12,11,7,terrorist,0
@SwiftyCommissh @TaoistInsight @ImmortalTech Some jewish ppl agree tht Israel is a bully nd a terrorist state killin palestine kids nd women,24,"['agree', 'is', 'nd']",3,18,17,6,terrorist,0
"RT AbbsWinston: #Zionist #Terrorist Demolish Tire Repair Shop Structure in #Bethlehem
http://t.co/ph2xLI8nVe http://t.co/22fuxHn7El",21,['terrorist'],1,1,0,20,terrorist,0
Three Israeli soldiers wounded in West Bank terrorist attack - Haaretz http://t.co/u4gSBNU8wc,14,['wounded'],1,8,7,6,terrorist,1
something is seriously wrong.suddenly deres one attack after anoder.Did a large contingency of terrorist... http://t.co/MVhjSelV5z,18,"['is', 'deres', 'anoder.Did']",3,14,13,4,terrorist,0
Stop using the money of tax layers of the country to feed bloody terrorist. Shot them and give a strong msg as other country does...,27,"['using', 'feed', 'give', 'does']",4,14,13,13,terrorist,0
Three Israeli soldiers wounded in West Bank terrorist attack via /r/worldnews http://t.co/su4ZVWADj7,14,['wounded'],1,8,7,6,terrorist,1
RT AbbsWinston: #Zionist #Terrorist kidnapped 15 #Palestinians in overnight terror on Palestinian Villages ├½Ôûê_ http://t.co/J5mKcbKcov,21,['kidnapped'],1,1,0,20,terrorist,0
#UdhampurAgain 2 terrorist shot dead.. #Udhampur,8,['terrorist'],1,4,3,4,terrorist,1
@RegaJha @sethiankit True also a racial attack in US perturbs buzzfeed India more than 3 back to back terrorist attacks on India..,24,"['perturbs', 'buzzfeed', 'back']",3,21,20,3,terrorist,0
[August 06 2015 at 08:02PM] Three Israeli soldiers wounded in West Bank terrorist attack via http://t.co/6nDHERpBoT,20,['wounded'],1,15,14,5,terrorist,1
@lovemywife1983 @FoxNews like shedid on 9/11 4the public facts I am not a journalist the Bush's washard on stopping more than just terrorist,26,"['am', 'stopping', 'terrorist']",3,26,25,0,terrorist,0
Isn't it ironic that on the anniversary of Hiroshima our current President is helping a terrorist nation acquire nuclear weapons. #TRAITOR,24,"['Is', 'ironic', 'is', 'helping', 'acquire']",5,17,16,7,terrorist,0
RT AbbsWinston: #Zionist #Terrorist kidnapped 15 #Palestinians in overnight terror on Palestinian Villages ├½Ôûê_ http://t.co/J5mKcbKcov,21,['kidnapped'],1,1,0,20,terrorist,1
Three Israeli soldiers wounded in West Bank terrorist attack via /r/worldnews http://t.co/9TyucdWh3g,14,['wounded'],1,8,7,6,terrorist,0
Angry Orchard Hard Cider Recalled Due To Threat of Exploding Bottles http://t.co/OXgefsoF2B,14,['Recalled'],1,1,0,13,threat,1
Most Popular Content Top story: Barrel Bombs Not ISIS Are the Greatest Threat├½Ôûê_ http://t.co/c8YYUWmefG see more http://t.co/BsMz4qlLBN,22,"['Are', 'see']",2,1,0,21,threat,0
@dmassa5 Definite triple crown threat. Him and Harper both.,12,['threat'],1,6,5,6,threat,0
Meek Mill responds to Drake├½Ôûê┬¼s OVO Fest set with wedgie threat http://t.co/qqSKYbARNg,14,['responds'],1,11,10,3,threat,0
Random wind gust just came through #Gander.  Probably some convection outflow.  Haven't heard any thunder yet but a few spits of rain #nlwx,28,"['came', 'Have', 'heard']",3,19,18,9,thunder,0
@OriginalFunko @Spencers THUNDER BUDDYS!!!! THUNDER BUDDYS!!!!,16,['thunder'],1,1,0,15,thunder,0
I don't wake up until another 2 hours &amp;&amp; I get interrupted . ????? I hate thunder .. ??,30,"['do', 'wake', 'get', 'interrupted', 'hate', 'thunder']",6,27,26,3,thunder,0
Heavy rain frequent thunder and gusty winds moving into parts of Uptown and Midtown. http://t.co/KQJevYqzLV - CN http://t.co/HmWhob7prs,23,['moving'],1,4,3,19,thunder,1
Thunder lightening torrential rain and a power cut!,9,['lightening'],1,1,0,8,thunder,1
The thunder shook my house woke my sister and made car alarms go off ????,18,"['shook', 'woke', 'made', 'go']",4,2,1,16,thunder,1
I hear lightening and see thunder,6,"['hear', 'lightening', 'see']",3,6,5,0,thunder,1
I was over here dreaming peacefully then that loud ass thunder wanted to scare me. ??,18,"['was', 'dreaming', 'wanted', 'scare']",4,11,10,7,thunder,0
@AsimTanvir @NemesisK_PES @KevR_7  Snow? Thunder and lightning?,12,['thunder'],1,1,0,11,thunder,0
"Oh shit its rly sheeting
Aaaaaand there's the thunder and lightning
I missed summer storms",16,"['shit', ""'s"", 'missed']",3,10,9,6,thunder,0
suddenly it's off &amp; on gloomy &amp; thunder so loud it shakes the windows? Not ever on the Bay Area. Miss me w/that lol http://t.co/x4eCGGvnSN,34,"[""'s"", 'shakes', 'lol']",3,13,12,21,thunder,1
#thunder outside my house this afternoon #gawx ??????????????????,27,['thunder'],1,2,1,25,thunder,1
it doesn't really get much better then summer thunder storms wrapped in a blanket. #icouldsitinthismomentforever,18,"['does', 'get', 'wrapped']",3,10,9,8,thunder,1
Idk if ithats thunder or people rolling in their trashcans ??????,16,['rolling'],1,4,3,12,thunder,0
@HaydnExists so glad i saved them all at once then didn├½Ôûê┬¼t want you stealing my thunder :P,19,"['saved', 'didn├½Ôûê┬¼t', 'want', 'stealing']",4,17,16,2,thunder,0
Severe Thunderstorm Warning for Oklahoma County until 10:30pm. Radar here: http://t.co/2HV2y2M2oZ #okwx,17,['thunderstorm'],1,1,0,16,thunderstorm,1
NIggas playing in the thunderstorm.. 'HOPE THE LORR BLESS EM' ????,15,"[""'HOPE""]",1,5,4,10,thunderstorm,0
#usNWSgov Special Weather Statement issued August 05 at 10:40PM EDT by NWS: ...STRONG THUNDERSTORM WILL IMPACT... http://t.co/TQ1rUQD4LG,23,['issued'],1,1,0,22,thunderstorm,1
Severe Thunderstorm Warning issued August 05 at 9:31PM CDT until August 05 at 10:15PM CDT by NWS http://t.co/h9i6moZAsK,20,['issued'],1,1,0,19,thunderstorm,1
OUN cancels Severe Thunderstorm Warning for Lincoln Logan Oklahoma [OK]  http://t.co/bTi8JAMFiu #WX,17,['thunderstorm'],1,1,0,16,thunderstorm,1
[HIGH PRIORITY] SEVERE THUNDERSTORM WATCH ENDED Issued for Red Deer [Updated: Aug 05th 20:29 MDT] http://t.co/ZrIyNa6f6m,23,['Updated'],1,1,0,22,thunderstorm,1
Severe Thunderstorm Warning until 10:30 PM local for Oklahoma County in OK. 60 Mph Wind Gusts And Half Dollar Size Hail. #okwx #myswc,26,['thunderstorm'],1,1,0,25,thunderstorm,1
#usNWSgov Severe Weather Statement issued August 05 at 10:38PM EDT by NWS: ...THE SEVERE THUNDERSTORM WARNING ... http://t.co/EpzgG4uqJI,23,['issued'],1,1,0,22,thunderstorm,1
@museawayfic @beenghosting @xylodemon ok ok what if I make the close quarters an abandoned cabin in the woods IN A THUNDERSTORM,24,"['ok', 'make', 'abandoned']",3,1,0,23,thunderstorm,0
NWS has Continued a Severe Thunderstorm Warning for Oklahoma-OK until 10:30 PM,12,"['has', 'Continued']",2,1,0,11,thunderstorm,1
New event. Severe Thunderstorm Warning from 8/5/2015 9:50 PM to 10:30 PM CDT for Oklahoma County. Mo,19,['thunderstorm'],1,1,0,18,thunderstorm,1
Stood there for 20 mics tryin to get a #lightning pic before settling for a vid. #okc #weather #summer #thunderstorm http://t.co/k2GJBOk6ft,29,"['get', 'lightning', 'settling']",3,26,25,3,thunderstorm,0
GSP issues STRONG THUNDERSTORM WILL IMPACT PORTIONS OF NORTHEASTERN PICKENS COUNTY UNTIL 1115 PM EDT for  Greater Pickens Pickens Mountain├½Ôûê_,20,['thunderstorm'],1,1,0,19,thunderstorm,1
A Dog Was Abandoned In A Thunderstorm. But Then A Neighbor Steps Up And Does THIS http://t.co/iR3OXEH7id,20,['Abandoned'],1,1,0,19,thunderstorm,0
THE NATIONAL WEATHER SERVICE IN LITTLE ROCK HAS ISSUED A * SEVERE THUNDERSTORM WARNING FOR... VAN BUREN COUNTY IN ├½Ôûê_ http://t.co/KJsvW06GBV,24,['thunderstorm'],1,1,0,23,thunderstorm,1
Severe Thunderstorm Warning for Oklahoma County in OK until 10:30pm. http://t.co/Iyq8gf437p,14,['thunderstorm'],1,1,0,13,thunderstorm,1
iNWS Alert SPSGSP from 8/5/2015 10:40 PM to 11:15 PM EDT for Pickens County: STRONG THUNDERSTORM WILL IMPACT... http://t.co/LdcwKyuaFf,23,['thunderstorm'],1,1,0,22,thunderstorm,1
RT @LivingSafely: #NWS issues Severe #Thunderstorm Warnings for parts of #AR #NC #OK. Expect more trauma cases: http://t.co/FWqfCKNCQW,28,['thunderstorm'],1,1,0,27,thunderstorm,1
Severe Thunderstorm Warnings have been cancelled in central Oklahoma. Still expect 50 mph winds penny sized hail,18,"['have', 'been', 'cancelled', 'expect', 'penny', 'sized']",6,1,0,17,thunderstorm,1
Just woke up to the loudest thunderstorm I've ever heard,11,"['woke', ""'ve"", 'heard']",3,7,6,4,thunderstorm,1
RT @LivingSafely: NWS posts Severe #Thunderstorm Warnings for parts of #AR #NC #OK. Seek strong shelter if at risk: http://t.co/kImr0l24Fb,29,['thunderstorm'],1,1,0,28,thunderstorm,1
GSP issues STRONG THUNDERSTORM WILL IMPACT PORTIONS OF NORTHEASTERN PICKENS COUNTY UNTIL 1115 PM EDT for  Greater Pickens Pickens Mountain├½Ôûê_,20,['thunderstorm'],1,1,0,19,thunderstorm,1
Severe Weather Statement issued August 05 at 9:33PM CDT by NWS: ...THE SEVERE THUNDERSTORM WARN... http://t.co/1EOf1Wxnpj #Skywarn #OKwx,25,['issued'],1,1,0,24,thunderstorm,1
OUN issues Severe Thunderstorm Warning for Oklahoma [OK] till 10:30 PM CDT http://t.co/do6H2pVuB4,17,['till'],1,1,0,16,thunderstorm,1
Severe Thunderstorm Warning including Russellville AR Clarksville AR Dardanelle AR until 10:15 PM CDT http://t.co/n844h1ASPj,17,['including'],1,1,0,16,thunderstorm,1
Special Weather Statement issued August 05 at 10:40PM EDT by NWS: ...STRONG THUNDERSTORM WILL IMPACT PORTIONS ... http://t.co/ulqeR1yTpX,22,['issued'],1,1,0,21,thunderstorm,0
RT @LivingSafely: NWS posts Severe #Thunderstorm Warnings for parts of #AR #NC #OK. Seek strong shelter if at risk: http://t.co/kEa5l3b1AE,29,['thunderstorm'],1,1,0,28,thunderstorm,1
Severe Thunderstorm Warning for Oklahoma County until 10:30pm. http://t.co/RsdkWZRc8g #okwx,14,['thunderstorm'],1,1,0,13,thunderstorm,1
Loud ass thunderstorm for no reason !??,9,['thunderstorm'],1,3,2,6,thunderstorm,0
Strong Thunderstorm 4 Miles East of Pickens Moving NE At 20 MPH. Pea Size Hail and Wind Gusts Up to 40 MPH... #scwx http://t.co/TsaLetFtkt,29,['Gusts'],1,1,0,28,thunderstorm,1
Severe Thunderstorm Warning for Oklahoma County in OK until 10:30pm CDT. #okwx,14,['thunderstorm'],1,1,0,13,thunderstorm,1
OUN continues Severe Thunderstorm Warning for Oklahoma [OK] till 10:30 PM CDT http://t.co/oIM6Po8XCu,17,"['continues', 'till']",2,1,0,16,thunderstorm,1
Severe Thunderstorm Warning including Midwest City OK Del City OK Choctaw OK until 10:30 PM CDT http://t.co/ogxSY4GWD1,19,['including'],1,1,0,18,thunderstorm,1
Severe Thunderstorm pictures from across the Mid-South http://t.co/UZWLgJQzNS,10,['thunderstorm'],1,1,0,9,thunderstorm,1
RT @LivingSafely: NWS posts Severe #Thunderstorm Warnings for parts of #AR #NC #OK. Seek strong shelter if at risk: http://t.co/HE4Qh2I5wF,29,['thunderstorm'],1,1,0,28,thunderstorm,1
Severe Thunderstorm Warnings have been cancelled in central Oklahoma. Still expect 50 mph winds penny sized hail,18,"['have', 'been', 'cancelled', 'expect', 'penny', 'sized']",6,1,0,17,thunderstorm,1
Pretty bad ass thunderstorm,4,['thunderstorm'],1,4,3,0,thunderstorm,1
[HIGH PRIORITY] SEVERE THUNDERSTORM WATCH ENDED Issued for Lethbridge [Updated: Aug 05th 20:29 MDT] http://t.co/yqYiwjN8eZ,22,['Updated'],1,1,0,21,thunderstorm,1
A STRONG THUNDERSTORM WILL AFFECT CENTRAL HALIFAX COUNTY THROUGH 1145 PM EDT for Halifax [VA] till 11:45 PM EDT http://t.co/MjSTefgGU5,24,"['AFFECT', 'till']",2,1,0,23,thunderstorm,1
"Thunderstorm in Helsinki
#thunder #lightning #lightningstrike #thunderstorm #nature #Helsinki├½Ôûê_ https://t.co/rJJXUcX5PM",18,['lightning'],1,11,10,7,thunderstorm,1
9:35 pm. Thunderstorm. No rain. 90 degrees. This weather weird.,15,['thunderstorm'],1,1,0,14,thunderstorm,1
NWS has issued a Severe Thunderstorm Warning for Oklahoma-OK until 10:30 PM,12,"['has', 'issued']",2,1,0,11,thunderstorm,1
#usNWSgov Severe Weather Statement issued August 05 at 10:38PM EDT by NWS: ...THE SEVERE THUNDERSTORM WARNING ... http://t.co/7HuEN4rWrn,23,['issued'],1,1,0,22,thunderstorm,1
Storm damage maybe a tornado near Chadbourn. See http://t.co/gAs4sS3dKS http://t.co/zlhVYArtCU,15,['See'],1,5,4,10,tornado,1
73rd GOODE Water Ski National Championships will go on as planned next week  http://t.co/PgKBT3MBAp. (Event w/ damage from a tornado on Mon),27,"['go', 'planned']",2,24,23,3,tornado,0
(AR)  Severe Thunderstorm Warning issued August 05 at 9:12PM CDT until August 05 at 9:45PM CDT by NWS http://t.co/AYfdjeB7Hy #arwx,25,['issued'],1,1,0,24,tornado,1
Second tornado confirmed in Sunday├½Ôûê┬¼s storm http://t.co/Ffnzit7kgN,9,['confirmed'],1,2,1,7,tornado,1
#tornado #singapore Mac and #cheese #around the world - mac cheese cookbook: http://t.co/rgAm3eQOwn Mac and Ch http://t.co/X6ZJpzB8UP,26,['tornado'],1,2,1,24,tornado,0
(OK)  Severe Thunderstorm Warning issued August 05 at 8:29PM CDT until August 05 at 9:15PM CDT by NWS http://t.co/O8X4M5eR6b #okwx,25,['issued'],1,1,0,24,tornado,1
I liked a @YouTube video http://t.co/itnKBxgWLH Lexi Belle for Oklahoma tornado victims,15,['liked'],1,14,13,1,tornado,0
@SakhalinTribune Calgary area tornado warnings end as thunderstorms move eastward,11,"['end', 'move']",2,5,4,6,tornado,1
http://t.co/Dg0EcBYKJL Tornado warnings end after thunderstorms hammer Calgary region for 2nd night #HeadlinesApp,16,"['end', 'hammer']",2,1,0,15,tornado,1
(AL)  Severe Thunderstorm Warning issued August 05 at 8:44PM CDT until August 05 at 9:15PM CDT by NWS http://t.co/bviYy8BMsb #alwx,25,['issued'],1,1,0,24,tornado,1
Environment Canada confirms 2nd tornado touched down last weekend ├òÔòÜ http://t.co/x8zqbwNfO1,13,"['confirms', 'touched', '├òÔòÜ']",3,5,4,8,tornado,1
Tornado warnings issued for southern Alberta http://t.co/zqmzAi8yIz,9,['issued'],1,1,0,8,tornado,1
Pizza and beer in a tornado in Austin. Windy af right now,13,['tornado'],1,6,5,7,tornado,0
Still can't get over the thunderstorm/tornado we were woken up to yesterday. Half the street is still in the dark! http://t.co/Y8h5v1j2y7,26,"['get', 'were', 'woken', 'is']",4,1,0,25,tornado,0
"@kunalkapoor Photo of the Day: Storm
Chaser
http://t.co/4WJy7seHmw
#photography #pod",16,['tornado'],1,1,0,15,tornado,0
@sarahnandola BTW we all live in libertyville now. Bc of the tornado,14,['live'],1,14,13,0,tornado,0
@Rebelmage2 I'm glad you got away XD But My 'be safe' was in reference to a tornado near calgary and drum heller at around 4 :O,30,"[""'m"", 'got', 'XD', 'was']",4,20,19,10,tornado,0
#TornadoGiveaway ├òÔò® #thebookclub ├òÔò® Join in!! https://t.co/8qucf6sgOc https://t.co/5U1t8hc4uf,16,['tornado'],1,1,0,15,tornado,0
Weak but distinct rotation fully condenses near Villa Ridge MO today near MCV center.  A 'sub-tornado?' Video: https://t.co/Fd9DzspuGk,24,['condenses'],1,1,0,23,tornado,0
Loving you was like throwing a lasso around a tornado I tried to hold on to.??,18,"['Loving', 'was', 'throwing', 'tried', 'hold']",5,10,9,8,tornado,0
Calgary area tornado warnings end as thunderstorms move eastward - CBC.ca: CBC.ca Calgary area tornado warnings end├½Ôûê_ http://t.co/ST9jPZ8Y24,21,"['end', 'move', 'end├½Ôûê_']",3,16,15,5,tornado,1
Illinois Tornado Slipped Under The Radar Emergency Officials Say http://t.co/P4KOfYtkdx,12,['tornado'],1,1,0,11,tornado,1
Maybe that's what happens when a tornado meets a volcano,11,"[""'s"", 'happens', 'meets']",3,8,7,3,tornado,0
I feel like a tornado http://t.co/iZJK6kpWiZ,8,['feel'],1,5,4,3,tornado,0
Rly tragedy in MP: Some live to recount horror http://t.co/TTb9oiL8R2 #TopStories #India timesofindia,18,"['live', 'recount']",2,2,1,16,tragedy,0
shit is hard to get over but sometimes the tragedy means it's over soulja..,15,"['is', 'get', 'means', ""'s""]",4,10,9,5,tragedy,0
Rly tragedy in MP: Some live to recount horror: ├½Ôûê┬ñWhen I saw coaches of my train plunging into water I called ... http://t.co/KiXRcBNjLs,27,"['live', 'recount', 'saw', 'called']",4,2,1,25,tragedy,0
Rly tragedy in MP: Some live to recount horror: ├½Ôûê┬ñWhen I saw coaches of my train plunging into water I called ... http://t.co/72ix7vM87w,27,"['live', 'recount', 'saw', 'called']",4,2,1,25,tragedy,0
Rly tragedy in MP: Some live to recount horror: ├½Ôûê┬ñWhen I saw coaches of my train plunging into water I called ... http://t.co/Calk5nv5Vc,27,"['live', 'recount', 'saw', 'called']",4,2,1,25,tragedy,0
'1 Death is a tragedy; a million Deaths is a statistic.' Stalin August 6 1945 U.S. Atomic Bomb Dropped On... http://t.co/kaMPx4eOS9,28,"['is', 'is', 'Dropped']",3,6,5,22,tragedy,0
Railways caught unawares by MP tragedy; Accident spot never marked as 'vulnerable' - Times of├½Ôûê_ http://t.co/cEdCUgEuWs #News,22,"['caught', 'marked']",2,6,5,16,tragedy,1
@MindfulYoga responds to the tragedy of #CecilTheLion http://t.co/5tPZ7loLlX #yoga #compassion @Hugger_Mugger http://t.co/MhIF6mPNTs,21,['responds'],1,6,5,15,tragedy,0
@MeekMill Have your beef Idgaf but you went too far when you used a tragedy where PEOPLE DIED to insult Drake. You owe T.O an apology.,29,"['went', 'used', 'insult', 'owe']",4,16,15,13,tragedy,0
Railways caught unawares by MP tragedy; Accident spot never marked as ├½Ôûê┬©vulnerable├½Ôûê┬¼ http://t.co/UB1JZskmRc,16,"['caught', 'marked']",2,6,5,10,tragedy,1
"@TOIIndiaNews ofcourse 

Just 8 minute b4 tragedy another train had crossed this place 

N a flash flood caued washing of tracks..",22,"['had', 'crossed', 'caued', 'washing']",4,8,7,14,tragedy,0
#ModiMinistry Rly tragedy in MP: Some live to recount horror http://t.co/s43wE7Oe2i,15,"['live', 'recount']",2,4,3,11,tragedy,0
Rly tragedy in MP: Some live to recount horror: ├½Ôûê┬ñWhen I saw coaches of my train plunging into water I called ... http://t.co/vScPGMsJXY,27,"['live', 'recount', 'saw', 'called']",4,2,1,25,tragedy,0
DTN India: Rly tragedy in MP: Some live to recount horror: ├½Ôûê┬ñWhen I saw coaches of my train plunging into water... http://t.co/WK63tm34a0,28,"['live', 'recount', 'saw']",3,5,4,23,tragedy,0
#breakingnews Rly tragedy in MP: Some live to recount horror: ├½Ôûê┬ñWhen I saw coaches of my train plunging into wa... http://t.co/eYOrBmF3O3,27,"['live', 'recount', 'saw']",3,4,3,23,tragedy,0
@itss_selenaluna like a beautiful ass tragedy lol,8,['tragedy'],1,7,6,1,tragedy,0
Rly tragedy in MP: Some live to recount horror: ├½Ôûê┬ñWhen I saw coaches of my train plunging into water I called ... http://t.co/0Xh758OnUP,27,"['live', 'recount', 'saw', 'called']",4,2,1,25,tragedy,0
jiwa mines Rly tragedy in MP: Some live to recount horror: ├½Ôûê┬ñWhen I saw coaches of my train plunging into water... http://t.co/LOEPKBS38J,27,"['live', 'recount', 'saw']",3,4,3,23,tragedy,0
Rly tragedy in MP: Some live to recount horror: ├½Ôûê┬ñWhen I saw coaches of my train plunging into water I called ... http://t.co/BdlqasD0wB,27,"['live', 'recount', 'saw', 'called']",4,2,1,25,tragedy,0
Rly tragedy in MP: Some live to recount horror: ├½Ôûê┬ñWhen I saw coaches of my train plunging into water I called ... http://t.co/CaR5QEUVHH,27,"['live', 'recount', 'saw', 'called']",4,2,1,25,tragedy,0
Robert Gagnon reviews the catastrophe of imposing same-sex marriage and how Christians should respond http://t.co/HIpklxpHnp,17,"['reviews', 'imposing', 'respond']",3,1,0,16,tragedy,0
Rly tragedy in MP: Some live to recount horror: ├½Ôûê┬ñWhen I saw coaches of my train plunging into water I called my├½Ôûê_ http://t.co/gDjTzkpCHK,27,"['live', 'recount', 'saw', 'called']",4,2,1,25,tragedy,0
Rly tragedy in MP: Some live to recount horror: ├½Ôûê┬ñWhen I saw coaches of my train plunging into water I called ... http://t.co/cSPAmWTo6T,27,"['live', 'recount', 'saw', 'called']",4,2,1,25,tragedy,0
Rly tragedy in MP: Some live to recount horror: ├½Ôûê┬ñWhen I saw coaches of my train plunging into water I c... http://t.co/AWWg8kNMZg Over.,29,"['live', 'recount', 'saw', 'c']",4,2,1,27,tragedy,0
Rly tragedy in MP: Some live to recount horror: ├½Ôûê┬ñWhen I saw coaches of my train plunging into water I called my daughters and said t...,29,"['live', 'recount', 'saw', 'called', 'said']",5,2,1,27,tragedy,0
Rly tragedy in MP: Some live to recount horror: ├½Ôûê┬ñWhen I saw coaches of my train plunging into water I called ... http://t.co/HR4GNyGSiC,27,"['live', 'recount', 'saw', 'called']",4,2,1,25,tragedy,0
Rly tragedy in MP: Some live to recount horror: ├½Ôûê┬ñWhen I saw coaches of my train plunging into water I called ... http://t.co/ZkgQSpwYj3,27,"['live', 'recount', 'saw', 'called']",4,2,1,25,tragedy,0
Rly tragedy in MP: Some live to recount horror: ├½Ôûê┬ñWhen I saw coaches of my train plunging into water I called ... http://t.co/21hsrrqZOu,27,"['live', 'recount', 'saw', 'called']",4,2,1,25,tragedy,0
Rly tragedy in MP: Some live to recount horror: ├½Ôûê┬ñWhen I saw coaches of my train plunging into water I called ... http://t.co/xtlJz7BjgL,27,"['live', 'recount', 'saw', 'called']",4,2,1,25,tragedy,0
Rt hirochii0: There is no country that making fun of Hiroshima 's tragedy but Korea. http://t.co/And1Btizao #Indonesia #Malaysia #Jamaica #├½Ôûê_,28,"['is', 'making']",2,14,13,14,tragedy,0
@CSAresu   American Tragedy http://t.co/SDmrzGErYX,7,['tragedy'],1,1,0,6,tragedy,0
"Leitchfield KY:

 Bella Edward &amp; Rosalie need rescue/adoption/local foster home(s)/sponsorships.

 Trapped &amp;... http://t.co/Ajay0sNPlg",26,['need'],1,1,0,25,trapped,1
@onihimedesu the whole city is trapped! You can't leave the city! This was supposed to be a normal sports manga wit a love triangle (c),31,"['is', 'trapped', 'leave', 'was', 'supposed', 'be', 'wit']",7,7,6,24,trapped,0
Bomb head? Explosive decisions dat produced more dead children than dead bodies trapped tween buildings on that day in September there,22,"['dat', 'produced', 'trapped']",3,14,13,8,trapped,0
Think of it as a reality TV show I tell myself to quell the panic rising in my throat. Introvert: Trapped in Tokyo. The 150-square-foot,28,"['tell', 'quell', 'Trapped']",3,1,0,27,trapped,0
(?EudryLantiqua?) Hollywood Movie About Trapped Miners Released in Chile: 'The 33' Holly... http://t.co/us1DMdXZVb (?EudryLantiqua?),27,['Released'],1,1,0,26,trapped,0
(#TeambrianMundial) Hollywood Movie About Trapped Miners Released in Chile: 'The 33' Holly... http://t.co/Ama6AVULnA (#TeambrianMundial),25,['Released'],1,1,0,24,trapped,0
Literally trapped in my room Cuz my bathroom being remodeled. The only exit is through a window,18,"['trapped', 'being', 'remodeled', 'is']",4,2,1,16,trapped,1
Hollywood Movie About Trapped Miners Released in Chile http://t.co/qkrLtrd39B,11,['Released'],1,1,0,10,trapped,0
Hollywood Movie About Trapped Miners Released in Chile: 'The 33' Hollywood movie about trapped min... http://t.co/BinNJwobtU #topstories,23,"['Released', 'trapped']",2,16,15,7,trapped,0
@BoyInAHorsemask its a panda trapped in a dogs body,10,['trapped'],1,6,5,4,trapped,0
Hollywood Movie About Trapped Miners Released in Chile: 'The 33' Hollywood movie about trapped miners starring... http://t.co/tyyfG4qQvM,22,"['Released', 'starring']",2,16,15,6,trapped,0
Hollywood Movie About Trapped Miners Released in Chile: 'The 33' Hollywood movie about trapped miners starring... http://t.co/0f8XA4Ih1U,22,"['Released', 'starring']",2,16,15,6,trapped,0
Hollywood movie about trapped miners released in Chile: SANTIAGO Chile (AP) ├½Ôûê├ï The Hollywood movie on the 33 m... http://t.co/RAzFkXbhMN,26,"['released', '├½Ôûê├ï']",2,4,3,22,trapped,0
1961 LES WOZNI In Hospital After He Broke His Leg Trapped in CAVE IN Press Photo http://t.co/7Rr4lo1lfW http://t.co/IOLOFaphsv,22,['Broke'],1,1,0,21,trapped,1
Photo: lavenderpoetrycafe: Trauma memories are encoded in images as trauma is a more sensory than cognitive... http://t.co/DMb6xP966D,22,"['are', 'encoded', 'is']",3,12,11,10,trauma,0
#NissanNews : Trauma Alert and 1 Child Among 6 Hospitalized After 2-Car Wreck on A1A Near Bing's Landing: The ... http://t.co/9dWyJqvFY4,26,['trauma'],1,1,0,25,trauma,1
@PTSD_Chat Yes. I feel the root of that is Shame - which can be found in the rubble of most trauma. #PTSDchat,26,"['feel', 'is', 'be', 'found']",4,23,22,3,trauma,0
Hiroshima: They told me to paint my story: Eighty-nine year old man recalls the terror and the trauma when the... http://t.co/spE7U8t40K,26,"['told', 'paint', 'recalls']",3,20,19,6,trauma,0
Photo: lavenderpoetrycafe: The Forgotten History of Sexual Trauma Hysteria was an affliction seen primarily... http://t.co/U2eS0Uk1u3,20,"['was', 'seen']",2,1,0,19,trauma,0
Trauma injuries involving kids and sport usually cycling related - CBC.ca http://t.co/0dQjereTXU,14,"['involving', 'cycling', 'related']",3,1,0,13,trauma,0
Butt Trauma Extraordinaire,3,['trauma'],1,1,0,2,trauma,0
Blood Memory: Intragenerational Trauma and the Death of Sandra Bland http://t.co/ZWeyGpHpf7,14,['trauma'],1,1,0,13,trauma,0
Esteemed journalist recalls tragic effects of unaddressed #childhood #trauma. @keithboykin @RandallPinkston @pozarmy  http://t.co/GXq1Auzb18,21,['recalls'],1,11,10,10,trauma,0
Hiroshima: They told me to paint my story: Eighty-nine year old man recalls the terror and the trauma when the... http://t.co/VhMbN4bn0b,26,"['told', 'paint', 'recalls']",3,20,19,6,trauma,0
Idk how I'm supposed to have my daughter in gymnastics and cheer at the same time? She refuses to make a choice. Ugh DIVA ??,29,"[""'m"", 'supposed', 'have', 'refuses', 'make']",5,1,0,28,trauma,0
Trauma can happen anywhere -- school home etc. -- at any time. Learn the ABC's of trauma and how to parent... ├½Ôûê_ http://t.co/fMj8MXJY8a,29,"['happen', 'Learn', 'parent']",3,20,19,9,trauma,0
80 @UChicago faculty members pushing university to overturn ban of trauma center protesters http://t.co/ta1yqclpSc http://t.co/xToHI1HexY,20,"['pushing', 'overturn', 'http']",3,12,11,8,trauma,0
PTSD research aims to answer a question left to future researchers in 1922 by a post WW1 inquiry http://t.co/gRDebWx70f,21,"['aims', 'answer', 'left']",3,1,0,20,trauma,0
@PyramidHead76 one good thing came out of watching the film.  Was too traumatised to watch show so started Halt &amp; Catch Fire on Amazon. :D,31,"['came', 'watching', 'traumatised', 'watch', 'started']",5,15,14,16,traumatised,0
@TremendousTroye I'm so traumatised,6,"[""'m""]",1,6,5,0,traumatised,0
"@PeterDutton_MP 
YOU DIDN'T 'STARE' DOWN 'PPL SMUGGLERS' 
YOU PAID THEM TO GO AWAY!
2 men died many traumatised children abused. #auspol",28,"['DID', ""'STARE"", 'PAID', 'died', 'abused']",5,23,22,5,traumatised,0
@michellemccann we had that last night - lightning for 2 hours! Poor Dawg traumatised. Ended up huddling in basement. @David_Williamso,25,"['had', 'traumatised', 'Ended', 'huddling']",4,16,15,9,traumatised,1
@disneyIrh so traumatised im ???? http://t.co/TATZfK63Ch,12,['traumatised'],1,4,3,8,traumatised,0
Still traumatised at the sight of an old woman throwing her shit out the window ?????,20,"['traumatised', 'throwing']",2,2,1,18,traumatised,0
@lovestheworld55 @SemiMooch so that's why you're now willing to believe nonsense - you were traumatised? Sorry to hear but bible still fake,27,"[""'s"", ""'re"", 'believe', 'were', 'traumatised', 'hear', 'bible', 'fake']",8,19,18,8,traumatised,0
@lucysforsale funny cause my dumb ass was the young one to get n trouble the most lol,18,"['was', 'get']",2,15,14,3,trouble,0
Pissed something off in the wood pile. Pulling pieces out and I get a small hiss and a series of low clicks for my trouble.,27,"['Pissed', 'Pulling', 'get']",3,26,25,1,trouble,0
RT MMDA: ADVISORY: Stalled Bus at EDSA Service Road Cubao SB due to mechanical trouble as of 7:53 AM. 1 lane occupied. MMDA T/C on site. T├½Ôûê_,32,"['Stalled', 'occupied', 'T├½Ôûê_']",3,17,16,15,trouble,1
@canagal Good to hear it's back.. that storm's been given you guys trouble though :( ^SJ,20,"['hear', ""'s"", 'been', 'given', 'guys', '^SJ']",6,16,15,4,trouble,1
Must black folks don't wanna stir up trouble .. Which in turn causes them to be silent on the injustice in the wrld. https://t.co/a5bKmsasjE,29,"['do', 'wan', 'stir', 'causes', 'be']",5,10,9,19,trouble,1
OH MY GOD RYANS IN TROUBLE http://t.co/ADIp0UnXHU,9,['trouble'],1,1,0,8,trouble,1
Strawberries are in big trouble. Scientists race to find solution. http://t.co/MqydXRLae7 http://t.co/EpJjkB4Be9,18,"['are', 'find']",2,5,4,13,trouble,0
@cspan #Prez. Mr. President you are the biggest terrorist and trouble maker in the world. You create terrorist you sponsor terrorist.,26,"['are', 'create', 'sponsor']",3,14,13,12,trouble,0
So did we have a hurricane tornado tsunami? Someone please tell me what the hell happened #nopower,19,"['did', 'have', 'tell', 'happened']",4,8,7,11,tsunami,0
@helene_yancey GodsLove &amp; #thankU my sister Helene for RT of NEW VIDEO http://t.co/cybKsXHF7d The Coming Apocalyptic US Earthquake &amp; Tsunami,28,"['thankU', '//t.co/cybKsXHF7d']",2,1,0,27,tsunami,0
TheDIYHacks: RT Illusionimagess: A tsunami cloud. http://t.co/H6t4x1EVTx,12,['tsunami'],1,7,6,5,tsunami,1
@TerriF77 GodsLove &amp; #thankU beloved sister Terri for RT of NEW VIDEO http://t.co/cybKsXHF7d The Coming Apocalyptic US Earthquake &amp; Tsunami,28,"['beloved', '//t.co/cybKsXHF7d']",2,1,0,27,tsunami,0
@DArchambau THX for your great encouragement and for RT of NEW VIDEO http://t.co/cybKsXHF7d The Coming Apocalyptic US Earthquake &amp; Tsunami,25,['//t.co/cybKsXHF7d'],1,1,0,24,earthquake,0
"Crptotech tsunami and banks.
 http://t.co/KHzTeVeDja #Banking #tech #bitcoing #blockchain",16,['bitcoing'],1,2,1,14,tsunami,1
When tsunami says your order will take 40 minutes and you placed your order when you were on your way ????,24,"['says', 'take', 'placed', 'were']",4,2,1,22,tsunami,0
An optical illusion - clouds rolling in over the mountains looks like a Tsunami - Geneva - Switzerland http://t.co/EyEVZIoPg1,21,"['rolling', 'looks']",2,1,0,20,tsunami,0
Earthquake and tsunami that occurred in Japan 'free speech' is also swallowed. http://t.co/TJyyFT6NV0,17,"['occurred', 'is', 'swallowed']",3,3,2,14,tsunami,1
"?#FUKUSHIMA?#TEPCO?
Mountains of debris from the Japanese tsunami have floated to the West Coast
http://t.co/y518jYrZav",23,"['have', 'floated']",2,14,13,9,tsunami,0
@slone did the First World War Ever Truly End? The Ripples Are With Still and have been compound into low level Tsunami,24,"['did', 'Are', 'have', 'been', 'compound']",5,1,0,23,tsunami,0
I hope this tsunami clears b4 i have to walk outside to my car ????,18,"['hope', 'clears', 'have', 'walk']",4,4,3,14,tsunami,0
@author_mike Amen today is the Day of Salvation. THX brother Mike for your great encouragement. - http://t.co/cybKsXHF7d Coming US Tsunami,25,"['is', 'Coming']",2,1,0,24,tsunami,0
and i dont get waves of missing you anymore theyre more like tsunami tides in my eyesss,17,"['i', 'dont', 'get', 'missing', 'anymore']",5,13,12,4,tsunami,0
I think Tsunami has hit the wall. Dang... #STLCards,12,"['think', 'has', 'hit']",3,1,0,11,tsunami,1
This high-tech sphere can be the key to saving lives during a tsunami. What would you pack in it? http://t.co/KwlpFqRBVp,24,"['be', 'saving', 'pack']",3,13,12,11,tsunami,0
Meet Brinco your own personal earthquake snd tsunami early warning beacon. http://t.co/NXkUM9h7wD,15,['tsunami'],1,8,7,7,tsunami,0
Help support the victims of the Japanese Earthquake and Pacific Tsunami http://t.co/O5GbPBQH http://t.co/MN5wnxf0 #hope4japan #pray4japan,21,['support'],1,1,0,20,tsunami,0
It's alil twister at Tha end to! I was like oh nah ??,16,"[""'s"", 'was']",2,4,3,12,twister,0
Gail and Russell saw lots of hail at their Dalroy home - they have video of twister 1/2 mile from their home #yyc http://t.co/3VfKEdGrsO,27,"['saw', 'have']",2,17,16,10,twister,0
"950. If a landslide tumbles down todayI'm on your side

And if a twister sweeps it all away-

YOU'RE ON YOUR OWN BITCH!*runs into distance*",30,"['tumbles', ""'m"", 'sweeps', '*runs']",4,16,15,14,twister,0
when you get stuck on the wicked twister and they have to call maintenance to get you out.. http://t.co/7iFPMFssMU,21,"['get', 'stuck', 'have', 'call', 'get']",5,8,7,13,twister,0
Crazy Mom Threw Teen Daughter a NUDE Twister Sex Party According To Her Friend50 =&gt;http://t.co/Hy5Pbe12TM http://t.co/c1nJpLi5oR,24,['According'],1,1,0,23,twister,0
Tornadoes: El Nino may give Canada's twister season a boost #Toronto http://t.co/agyCutKBnN,17,['give'],1,9,8,8,twister,0
#Breaking144 Obama Declares Disaster for Typhoon-Devastated Saipan: Obama signs disaster declarat... http://t.co/M8CIKs60BX #AceNewsDesk,19,['typhoon'],1,1,0,18,typhoon,1
Map: Typhoon Soudelor's predicted path as it approaches Taiwan; expected to make landfall over southern China by S├½Ôûê_ http://t.co/JDVSGVhlIs,24,"['approaches', 'expected', 'make']",3,1,0,23,typhoon,1
Find out how your fund was used for Typhoon Haiyan in the Philippines. See @DevPeace Haiyan Relief Funds Report http://t.co/JwxrX1LsqO,24,"['Find', 'was', 'used', 'See']",4,1,0,23,typhoon,0
Global precipitation measurement satellite captures 3-D image of Typhoon Soudelor - NASAHurricane. Visit: http://t.co/sQN4girdvZ,18,['captures'],1,1,0,17,typhoon,0
Struggling to Return to Life: Makurazaki Typhoon on September 17 1945 killed thousands. http://t.co/fmp0JsH4wX http://t.co/X3TotYZAZe,21,"['Struggling', 'Return', 'killed']",3,1,0,20,typhoon,0
Obama Declares Disaster for Typhoon-Devastated Saipan: Obama signs disaster declaration for Northern Marians a... http://t.co/Hni4v2ZUk3,19,['Declares'],1,1,0,18,typhoon,1
Obama Declares Disaster for Typhoon-Devastated Saipan: Obama signs disaster declaration for Northern Marians a... http://t.co/UsVyHdG9OG,19,['Declares'],1,1,0,18,typhoon,1
#Map: Typhoon Soudelor's predicted path as it approaches Taiwan; expected to make landfall over southern China by ├½Ôûê_ http://t.co/PgD7UXtVGg,25,"['approaches', 'expected', 'make']",3,1,0,24,typhoon,1
#breaking #news Global precipitation measurement satellite captures 3-D image of Typhoon Soudelor - @NASAHurricane http://t.co/20DNcthr4D,20,"['breaking', 'captures']",2,1,0,19,typhoon,1
Obama Declares Disaster for Typhoon-Devastated Saipan: Obama signs disaster declaration for Northern Marians a... http://t.co/Q3DtOqO04c,19,['Declares'],1,1,0,18,typhoon,1
Obama signs disaster declaration for Northern Marians after typhoon hits US territory  http://t.co/0IPaVKJgDC,15,['typhoon'],1,9,8,6,typhoon,1
Obama Declares Disaster for Typhoon-Devastated Saipan: Obama signs disaster declaration for Northern Marians a... http://t.co/qjuU0wcWPx,19,['Declares'],1,1,0,18,typhoon,1
@FoxNews let me report it to u people instead Mr.Obama just declares CNMI federal disaster area post typhoon soudelor. U guys 2slow2report.,25,"['let', 'report', 'declares', 'guys']",4,19,18,6,typhoon,1
abcnews - Obama Declares Disaster for Typhoon-Devastated Saipan: Obama signs disaster declaration for Northern... http://t.co/mg5eAJElul,19,['Declares'],1,1,0,18,devastated,1
Typhoon Soudelor: When will it hit Taiwan ├½Ôûê├è and how bad will it be? #GeneralNews http://t.co/cWZHgEzAJ4,21,"['hit', 'be']",2,1,0,20,typhoon,0
Obama Declares Disaster for Typhoon-Devastated Saipan: Obama signs disaster declaration for Northern Marians a... http://t.co/9i6CrCRq2m,19,['Declares'],1,1,0,18,devastated,1
RT_America: RT RT_com: Eye of Super Typhoon Soudelor seen from space (TIME-LAPSE) https://t.co/FC3BxRtHPG http://t.co/BIU4koWGlz,22,['seen'],1,1,0,21,typhoon,0
Typhoon Soudelor taking dead aim at Taiwan http://t.co/3Ac5wuy1R0,10,['taking'],1,1,0,9,typhoon,1
Global precipitation measurement satellite captures 3-D image of Typhoon Soudelor - @NASAHurricane http://t.co/iGCEtuMkcW,16,['captures'],1,1,0,15,typhoon,0
Obama Declares Disaster for Typhoon-Devastated Saipan http://t.co/CanEyTtwEV #international,11,['Declares'],1,1,0,10,typhoon,1
Typhoon Soudelor heads for Taiwan http://t.co/Pg0BhL6FQC #wtf #news #tv #fun #funny,18,['typhoon'],1,1,0,17,typhoon,1
nbanews Soudelor Typhoon Soudelor is taking dead aim at Taiwan and is expected to make landfall Friday according to the Joint Typhoon├½Ôûê_,22,"['is', 'taking', 'is', 'expected', 'make', 'according']",6,1,0,21,typhoon,0
(#LosDelSonido) Obama Declares Disaster for Typhoon-Devastated Saipan: Obama signs disaster declaration for Northern Ma...  (#IvanBerroa),23,['Declares'],1,1,0,22,devastated,1
Obama Declares Disaster for Typhoon-Devastated Saipan: Obama signs disaster declaration for Northern Marians a... http://t.co/PC8BvufLFJ,19,['Declares'],1,1,0,18,typhoon,1
Obama Declares Disaster for Typhoon-Devastated Saipan: Obama signs disaster declaration for Northern Marians a... http://t.co/BHZr9UgUs2,19,['Declares'],1,1,0,18,typhoon,1
Obama Declares Disaster for Typhoon-Devastated Saipan,6,['Declares'],1,1,0,5,devastated,1
Obama Declares Disaster for Typhoon-Devastated Saipan: Obama signs disaster declaration for Northern Marians a... http://t.co/VTS9CAyiBC,19,['Declares'],1,1,0,18,typhoon,1
Price of vegetables rises on Typhoon Soudelor concerns http://t.co/GeI58Vhbw6,11,['typhoon'],1,1,0,10,typhoon,0
UK WEATHER ALERT: Remnants of Asian super typhoon Soudelor to cause VIOLENT ... - http://t.co/JXOcfzKyw7 http://t.co/sZx1v2mk8K,21,['cause'],1,9,8,12,typhoon,1
Map: Typhoon Soudelor's predicted path as it approaches Taiwan; expected to make landfall over southern China by... http://t.co/YvaFI3zuJx,24,"['approaches', 'expected', 'make']",3,1,0,23,typhoon,1
Obama Declares Disaster for Typhoon-Devastated Saipan: Obama signs disaster declaration for Northern Marians after typhoon hits US territory,19,['Declares'],1,16,15,3,typhoon,1
Photos: Typhoon Soudelor Has Its Aim Set on Taiwan and├òÔò®China http://t.co/3OG66NfSIG,14,['typhoon'],1,1,0,13,typhoon,1
Massive Typhoon heads toward Taiwan. http://t.co/Na2Ey64Vsg,9,['typhoon'],1,1,0,8,typhoon,1
A GPM satellite 'bullseye' in Typhoon Soudelor http://t.co/7vcEzi6CbB,11,['typhoon'],1,1,0,10,typhoon,1
Global precipitation measurement satellite captures 3-D image of Typhoon Soudelor - @NASAHurricane http://t.co/MvSRjd4X3D,16,['captures'],1,1,0,15,typhoon,0
#Trending #Viral Spectacular satellite view of Typhoon Soudelor @rumblevideo http://t.co/VkF0gkZ9N3,15,['Trending'],1,1,0,14,typhoon,0
"#WorldNews #World
 Saipan Has No Water Electricity in Typhoon Aftermath - Voice of America - World - Google News.. http://t.co/5sUdXgNdA3",24,['typhoon'],1,1,0,23,typhoon,0
Striking views of Super Typhoon Soudelor as it tracks toward Taiwan China http://t.co/hsjp6Hoffe,15,"['Striking', 'tracks']",2,1,0,14,typhoon,0
Saipan has no water electricity in aftermath of typhoon http://t.co/UBAk5uOI48,12,['has'],1,9,8,3,typhoon,1
Map: Typhoon Soudelor's predicted path as it approaches Taiwan; expected to make landfall over southern China by S├½Ôûê_ http://t.co/0XCb7yeqmw,24,"['approaches', 'expected', 'make']",3,1,0,23,typhoon,1
A GPM satellite 'bullseye' in Typhoon Soudelor http://t.co/piVeUPiRKY,11,['typhoon'],1,1,0,10,typhoon,1
"4Yygb mhtw4fnet

Thousands evacuated as Taiwan prepares for strongest typhoon of 2015 - ABC Online",15,"['evacuated', 'prepares']",2,10,9,5,typhoon,0
I think a Typhoon just passed through here lol,9,"['think', 'passed']",2,1,0,8,typhoon,1
Please recover from the Typhoon. ????,10,['Please'],1,1,0,9,typhoon,0
Obama Declares Disaster for Typhoon-Devastated Saipan: Obama signs disaster declaration for Northern Marians a... http://t.co/a1MoeJxqyA,19,['Declares'],1,1,0,18,devastated,1
#abc Obama Declares Disaster for Typhoon-Devastated Saipan http://t.co/ueHFZTeYHu #international #news,15,['typhoon'],1,1,0,14,typhoon,1
#ABCNews Obama Declares Disaster for Typhoon-Devastated Saipan: Obama signs disaster declaration for No... http://t.co/DOBZc3piTM #World,21,['typhoon'],1,1,0,20,typhoon,1
Obama Declares Disaster for Typhoon-Devastated Saipan: Obama signs disaster declaration for Northern Marians a... http://t.co/lEYJwNnAH8,19,['Declares'],1,1,0,18,devastated,1
Typhoon Soudelor taking dead aim at Taiwan http://t.co/sA5CDWVDXt,10,['taking'],1,1,0,9,typhoon,1
Where bottle cherry timbering facilities upheaval entryway?: fJiZzTxK,10,['timbering'],1,6,5,4,upheaval,0
"How long O Lord (Study 3)
 The sixth seal opens the events of Revelation 12. The political upheaval in the Roman... http://t.co/GW0CXoOJyV",28,['opens'],1,21,20,7,upheaval,0
Ancient Mayan Tablet Found in Jungle Temple http://t.co/qp6q8RS8ON,10,['upheaval'],1,1,0,9,upheaval,1
A Look at State Actions a Year after Ferguson├½Ôûê┬¼s Upheaval https://t.co/M4tuI0P9nT MD is mentioned in the last group for a 'reporting' bill,25,"['is', 'mentioned', ""'reporting""]",3,1,0,24,upheaval,0
A Look at State Actions a Year After #Ferguson's Upheaval http://t.co/qwSbVfLPE1,15,['upheaval'],1,1,0,14,upheaval,0
"@nytimes 
Due to upheaval created by the west in Iraq Syria Libya etc.",15,"['upheaval', 'created']",2,5,4,10,upheaval,0
This week we received the sad news of our friends daughters cancer prognosis. This is the second upheaval in this... http://t.co/tpOptWMWFR,25,"['received', 'is']",2,19,18,6,upheaval,0
A look at state actions a year after Ferguson's upheaval http://t.co/vXUFtVT9AU,14,['upheaval'],1,11,10,3,upheaval,0
@RoxYunkFalls August 4 1915 http://t.co/jjNS0YjaLA Violent storm strikes city Manayunk flooding and damage. Sports &amp; War news,23,['violent storm'],1,1,0,22,violent storm,1
Terrifying POV footage captures violent landing from inside a passenger jet during a storm in Amsterdam http://t.co/NqXQYI70W4 #travel,21,"['Terrifying', 'landing']",2,1,0,20,violent storm,0
@hippieXox If the word 'violent' comes to mind it's food poisoning. Nothing you can do but weather the storm about 24 hours.  :(,29,"['comes', 'mind', ""'s"", 'do', 'weather']",5,1,0,28,violent storm,0
And Kolkata is struck by a Cyclonic Storm. Sumthng big is gonna happen 2day evng. Heavy rains nd a violent storm approachng. God help us.,30,"['is', 'struck', 'is', 'gon', 'happen', 'rains', 'help']",7,1,0,29,violent storm,1
Rather violent storm. Possibility of no stream tonight.,10,['violent storm'],1,1,0,9,violent storm,0
Violent Storm Causes Damage Flooding in Watertown - http://t.co/3ZASZ6wxjJ,11,['violent storm'],1,1,0,10,violent storm,1
More Severe Weather Heads Toward Chicago Area: A brief violent storm swept through the Chicago area Sunday af... http://t.co/JWSLLsuKjg,23,['swept'],1,1,0,22,violent storm,1
Terrifying POV footage captures violent landing from inside a passenger jet during a storm in Amsterdam http://t.co/TyAOYEpelz,19,"['Terrifying', 'landing']",2,1,0,18,violent storm,0
[WP] You work on the top floor of a hotel when suddendly a violent storm comes the news proclaims your city in a ├½Ôûê_ http://t.co/S6Rc7dbAL1,29,"['work', 'comes', 'proclaims']",3,1,0,28,violent storm,0
"Thunder pounds north goes black
a deep bruise on the sky's chest
wind cries its pain.  
A summer storm has a tough life
short violent.",28,"['goes', 'cries', 'has']",3,1,0,27,violent storm,1
#stormchase Violent Record Breaking EF-5 El Reno Oklahoma Tornado Nearly Runs Over ... - http://t.co/3SICroAaNz http://t.co/I27Oa0HISp,21,['violent storm'],1,1,0,20,violent storm,1
RT @calgarysun: Sun photographer Stuart Dryden spotted this vortex spun off a violent storm in Sylvan Lake. #abstorm http://t.co/w0BZ0JNGvB,25,"['spotted', 'spun']",2,1,0,24,violent storm,1
#Amsterdam POV video captures violent landing at Amsterdam Airport Schiphol during a st... http://t.co/AlUMrGl40e http://t.co/8h2KCTFB8I,21,['landing'],1,1,0,20,violent storm,0
After a violent afternoon storm more severe weather heads for Chicago tonight. Details ----&gt; http://t.co/6Peeip4y7W,22,['violent storm'],1,1,0,21,violent storm,1
I don't understand 'taking' ANY life as a trophy. It's violent killing. http://t.co/NEqW47E1uj #CecilTheLion #BADChoices #BANTROPHYHUNTING,26,"['do', 'understand', ""'taking"", ""'s"", 'killing']",5,1,0,25,violent storm,0
Holy crap! BRAVO Sir! Amazing! Dramatic Video Shows Plane Landing During Violent Storm http://t.co/xB0bw8h8Ur,19,['violent storm'],1,1,0,18,violent storm,0
"Violent Forces Radio: Now Playing Acid Storm - Scourgue Of The Gods
TuneIn Player @ http://t.co/XsSgEdSbH4",19,['Playing'],1,1,0,18,violent storm,0
Circus tent collapses in violent storm killing 2 kids in New Hampshire http://t.co/j0saXEKBTa,15,['killing'],1,1,0,14,violent storm,0
"U.S.PACIFIC COMMAND.
I can see it!
They gave their all in the peace unity festival
It disappears when freedom
A Violent Storm hit Sea",26,"['see', 'gave', 'festival', 'disappears', 'hit']",5,1,0,25,violent storm,0
@Vickie627 Desert Storm was an unqualified victory a treaty was signed.  Under Clinton the situation only got worse and more violent. #tcot,26,"['was', 'was', 'signed', 'got']",4,1,0,25,violent storm,0
Storm is here! Violent winds and pounding rains in Evergreen. #yyc,14,"['is', 'pounding']",2,1,0,13,violent storm,0
POV footage captures violent landing from inside plane during storm http://t.co/kxewlHH7Uw,13,['landing'],1,1,0,12,violent storm,0
Stay inside for the next little while kids. We're having a bit of a violent storm right now. -kjc,22,"[""'re"", 'having']",2,1,0,21,violent storm,0
Watch: Violent Storm Causes Deadly Accident at New Hampshire Circus http://t.co/jpPiR3ZzKA #GMA http://t.co/nV5GCDpIBA,19,['violent storm'],1,1,0,18,violent storm,1
Dramatic Video Shows Plane Landing During Violent Storm - http://t.co/oQ0LnF2Yug http://t.co/tZDBcGpSAg,15,['violent storm'],1,1,0,14,violent storm,1
Dramatic Video Shows Plane Landing During Violent Storm http://t.co/XRgPdlSWfD,11,['violent storm'],1,1,0,10,violent storm,1
POV video captures violent landing at Amsterdam Airport Schiphol during a storm ... http://t.co/fkv5qXDcy3,16,['landing'],1,1,0,15,violent storm,1
Storm blitzes Traverse City disrupts Management Briefing Seminars: A violent summer storm blitzed through Tra... http://t.co/NKAW9EZqGg,20,"['blitzes', 'disrupts', 'blitzed']",3,1,0,19,violent storm,1
This is one violent and belligerent storm. I'm enjoying watching it unfold,14,"['is', ""'m"", 'enjoying', 'watching']",4,1,0,13,violent storm,0
@iateyourfood yikes.  Poor pup.  What a weird violent storm.,13,['violent storm'],1,1,0,12,violent storm,0
A brief violent storm swept through the Chicago area Sunday afternoon leading to one death and an evacuation of Lollapalooza and more,22,"['swept', 'leading']",2,1,0,21,violent storm,1
#calgaryweather  It would be nice if they would fix radar before another violent storm  Uninformed citizens dangerous #YYC #yycweather,22,"['be', 'fix', 'citizens']",3,1,0,21,violent storm,0
Storm batters top half of North Island: A violent overnight storm has battered the upper North Island uprootin... http://t.co/fHVOkmpheD,23,"['has', 'battered']",2,1,0,22,violent storm,1
Slow clap for this pilot. Dramatic Video Shows Plane Landing During Violent Storm http://t.co/CgVUY3RcxO,17,['violent storm'],1,1,0,16,violent storm,0
If you were the NWS wth a rotating storm w/ a report of a 'HUGE' / 'MASSIVE' / 'VIOLENT' tornado what would you do? https://t.co/J3dI85IST5,31,"['were', 'rotating', 'w/', 'do', 'https']",5,1,0,30,violent storm,0
Dramatic Video Shows Plane Landing During Violent Storm http://t.co/rJ9gkJKJJn,11,['violent storm'],1,1,0,10,violent storm,0
2012#Shell's 250-foot-tall drilling rig broke loose from a towline&amp;drifted out of control during violent winter storm #incompetent #shellno,27,"['broke', 'drifted']",2,1,0,26,violent storm,1
POV video captures violent landing at Amsterdam Airport Schiphol during a storm - Daily Mail http://t.co/seShqN5DSK #Amsterdam #News,22,['landing'],1,1,0,21,violent storm,0
"Violent video: Ukraine rioters brutally beat police storm local admin building
WE'RE ALL FIGHTING BACK  http://t.co/Byj5Dfa2rv",20,"['beat', 'storm']",2,1,0,19,violent storm,0
Jetstar and Virgin forced to cancel Bali flights again because of ash from Mount Raung volcano http://t.co/jTJoFLtMS4,19,"['forced', 'cancel']",2,16,15,3,volcano,1
"nside a Dragon's belly. Or an ice cave under
a volcano in Kamchatka | Photography by
├ò┬«Daniel Korzhonov
http://t.co/8T36HWgoqd",25,['volcano'],1,13,12,12,volcano,0
"Japan Aogashima Volcano. By Unknown - Check It Out! http://t.co/OegFQBIqIq
 #Aogashima #Japan #photography #Volcano",22,['Check'],1,1,0,21,volcano,0
#Earthquake #Sismo M 1.9 - 5km S of Volcano Hawaii: Time2015-08-06 01:04:01 UTC2015-08-05 15:04:01 -10:00 at ... http://t.co/eTswuoD3oM,23,['volcano'],1,1,0,22,volcano,1
1.94 earthquake occurred 5km S of Volcano Hawaii at 01:04 UTC! #earthquake #Volcano http://t.co/auf4J4Owj1,19,['occurred'],1,1,0,18,volcano,1
1.9 #Earthquake in 5Km S Of Volcano Hawaii #iPhone users download the Earthquake app for more information http://t.co/V3aZWOAmzK,22,['download'],1,1,0,21,volcano,1
Eruption of Indonesian volcano sparks transport chaos: In this picture done from video Mount Raung in├½Ôûê_ http://t.co/7muG2kAhL7 ?,21,"['transport', 'done']",2,4,3,17,volcano,1
The sunset looked like an erupting volcano .... My initial thought was the Pixar short Lava http://t.co/g4sChqFEsT,20,"['looked', 'erupting', 'was']",3,1,0,19,lava,0
USGS reports a M1.94 #earthquake 5km S of Volcano Hawaii on 8/6/15 @ 1:04:01 UTC http://t.co/Njd28pg9Xv #quake,21,['reports'],1,6,5,15,earthquake,1
USGS EQ: M 1.9 - 5km S of Volcano Hawaii: Time2015-08-06 01:04:01 UTC2015-08-05 15:04:01 -10:00 a... http://t.co/3rrGHT4ewp #EarthQuake,24,['earthquake'],1,1,0,23,earthquake,1
#USGS M 1.9 - 5km S of Volcano Hawaii: Time2015-08-06 01:04:01 UTC2015-08-05 15:04:01 -10:00 at epicenter... http://t.co/dIsrwhQGym #SM,24,['volcano'],1,1,0,23,volcano,1
@MrMikeEaton @Muazimus_Prime hill hill mountain volcano of hell mountain hill hil.,14,['mountain'],1,8,7,6,volcano,0
@Jesssssssee @eevans17 The Illuminati: The Yellowstone Super Volcano Conspiracy http://t.co/wymv9cYxzK,15,['eevans17'],1,1,0,14,volcano,0
idgaf fly into a volcano,5,['volcano'],1,5,4,0,volcano,0
M1.94 [01:04 UTC]?5km S of Volcano Hawaii. http://t.co/zDtoyd8EbJ,15,['['],1,1,0,14,volcano,1
?? @ KETEP VOLCANO CENTRE ketep PASS https://t.co/IdBnKxu80L,11,['volcano'],1,1,0,10,volcano,0
#USGS M 1.9 - 5km S of Volcano Hawaii: Time2015-08-06 01:04:01 UTC2015-08-05 15:04:01 -10:00 at epicenter... http://t.co/meVvkaXcdE #SM,24,['volcano'],1,1,0,23,volcano,1
I added a video to a @YouTube playlist http://t.co/y2Mt6v13E8 Doc: Volcanoes and Earthquakes - Inside the Volcano,21,['added'],1,1,0,20,volcano,0
Not only does he know the latest research the kiddo's GI specialist sang the volcano number from Inside Out. Now THAT is whole person care.,28,"['does', 'know', 'sang', 'is']",4,16,15,12,volcano,0
#Sismo M 1.9 - 5km S of Volcano Hawaii: Time2015-08-06 01:04:01 UTC2015-08-05 15:04:01 -10:00 at epicente... http://t.co/K28mgWTZcV #CS,24,['volcano'],1,1,0,23,volcano,1
@alextucker VOLCANO BOWL DRINK,5,['volcano'],1,1,0,4,volcano,0
Quake: M 1.9 - 5km S of Volcano Hawaii,10,['volcano'],1,1,0,9,volcano,1
Zeal is a volcano the peak of which the grass of indecisiveness does not grow,15,"['is', 'does', 'grow']",3,4,3,11,volcano,0
@volcano_tornado live somewhere else for a while and Da Mill ain't too bad son! #perspective,19,"['live', 'ai']",2,2,1,17,volcano,0
#Sismo M 1.9 - 5km S of Volcano Hawaii: Time2015-08-06 01:04:01 UTC2015-08-05 15:04:01 -10:00 at ep... http://t.co/RTUeTdfBqb #CSismica,24,['volcano'],1,1,0,23,volcano,1
The Architect Behind Kanye West's Volcano - New York Times http://t.co/3QJUExX0Y0,14,['volcano'],1,1,0,13,volcano,1
Thank you to @scegnews! Our neighborhood looks like a war zone but we had power back in 4 hours!,22,"['@', 'had']",2,1,0,21,war zone,1
Sammy is here in this war zone. Jamal spoke to me on the phone. Now my wife is next to speak to me ...what else can&gt; http://t.co/2CppfprxoG,35,"['is', 'spoke', 'is', 'speak', 'gt']",5,1,0,34,war zone,0
the war on drugs has turned the U.S. into a WAR zone.,13,"['has', 'turned']",2,1,0,12,war zone,0
Saipan looks like a war zone though,7,['looks'],1,1,0,6,war zone,0
#DebateQuestionsWeWantToHear If U start another war would U B willing 2 go 2 the war-zone yourself or send UR sons and/or daughters 2 fight?,26,"['start', 'U', 'go', 'send', 'and/or']",5,1,0,25,war zone,0
#WorldWatchesFerguson #Florida @GovJayNixon @clairecmc How dare you turn our streets into a war zone -a war against CITIZENS?,23,"['clairecmc', 'turn']",2,1,0,22,war zone,0
Looks and sounds like a war zone,7,['sounds'],1,1,0,6,war zone,0
Um OK '@dandre_5: Sundays during football seasonfrom about 9 am - 11 pm women shouldn't even log onshit be a complete war zone',28,"['am', 'log', 'be']",3,1,0,27,war zone,0
Just trying to find my my peace in a Zone of war,12,"['trying', 'find']",2,1,0,11,war zone,0
The Resistance wages guerrilla warfare against KPA forces in the Red Zone the war-torn outskirts of... http://t.co/WFxAwQvvjr,20,['guerrilla'],1,1,0,19,war zone,0
THIS IS A ONE DIRECTION CONCERT NOT A WAR ZONE WHAT IS THIS #OTRAMETLIFE http://t.co/PtY9HRCUZH,18,"['IS', 'IS']",2,1,0,17,war zone,0
Looks like a war zone outside. What's going on?,12,"[""'s"", 'going']",2,1,0,11,war zone,1
70 years ago today the U.S.  dropped a nuclear weapon on Japan. Here are some articles that share my opinion on that decision├½Ôûê_,24,"['dropped', 'are']",2,10,9,14,weapon,0
Abe government said the missiles were not 'weapon' so JSDF could provide them to the ally when collective self defense right was exercised.,25,"['said', 'were', ""'weapon"", 'provide', 'was', 'exercised']",6,1,0,24,weapon,0
Please allow me to reiterate it's not the weapon it's the mindset of the individual! #professional #help! -LEGION! https://t.co/2lGTZkwMqW,28,"['allow', 'reiterate', ""'s"", ""'s""]",4,10,9,18,weapon,0
Cat Of Nine Irons XII: This nightmarishly brutal weapon is used in ritualistic country club de http://t.co/xpFmR368uF http://t.co/nmAUMYdKe1,23,"['is', 'used']",2,10,9,13,weapon,0
Iranian warship points weapon at U.S. helicopter official says http://t.co/SnqfHpYm3O #tcot,14,"['weapon', 'says']",2,4,3,10,weapon,1
BREAKING: Obama Officials GAVE Muslim Terrorist the Weapon Used in Texas Attack http://t.co/RJcaxjp4oS,16,['Used'],1,1,0,15,weapon,0
@abcnews A nuclear bomb is a terrible weapon!!,11,"['abcnews', 'is']",2,9,8,2,weapon,0
Rare insight into #terror and How to fight it http://t.co/t6OBVWaPhW #Cameroon #USA #Whitehouse #ES #FR #Nigeria #UK #Africa #DE #CA #AU #JP,37,['fight'],1,1,0,36,weapon,0
Abe's government made clear that grenades were not 'weapon.',12,"['made', 'were', ""'weapon""]",3,1,0,11,weapon,0
Even if u have your weapon and your badge we gonna put them choppas on your ass????,22,"['have', 'gon', 'put', 'choppas']",4,6,5,16,weapon,0
On 70th anniversary of #Hiroshima bomb it is important to learn from history and ban this weapon.,19,"['is', 'learn']",2,18,17,1,weapon,0
That day remember the nuclear weapon power......Hiroshima 70th,11,['remember'],1,6,5,5,weapon,0
03/08/11: Police stop a 41-year-old in the Bronx citing 'casing a victim or location.' No weapon is found.,22,"['stop', 'citing', ""'casing"", 'is', 'found']",5,19,18,3,weapon,1
"Lol
Look how tough some people talk that live in some of the most gang infested cities in America
Your mouth isn't a weapon
You fucking wimp",28,"['talk', 'live', 'is', 'fucking', 'wimp']",5,25,24,3,weapon,0
Iranian warship points weapon at American helicopter... http://t.co/cgFZk8Ha1R,11,['weapon'],1,4,3,7,weapon,1
Agreed there - especially on automatic weapons. There's no legitimate reason for needing one @Argus_99 @HeidiA1438,20,"[""'s"", 'needing']",2,7,6,13,weapons,0
I'm sorry but if you have to resort to weapons to settle something you're a pussy win or lose take your shit like a man &amp; leave it at that,34,"[""'m"", 'have', 'resort', 'settle', ""'re"", 'lose', 'take', 'leave']",8,11,10,23,weapons,0
Incredulous at continued outcry of welfare being a waste of taxpayers money but never similar objection to ├ò├║100bn on nuclear weapons,21,"['being', '├ò├║100bn']",2,21,20,0,weapons,0
Since the chemical-weapons 'red line' warning on 20 August 2012 LCC have confirmed that at least 96355 people have been killed in #Syria.,26,"[""'red"", 'warning', 'have', 'confirmed', 'have', 'been', 'killed']",7,1,0,25,weapons,0
Friendly reminder that the only country to ever use nuclear weapons is the U.S. And it was against civilians. https://t.co/7QrEPylLUK,23,"['use', 'is', 'was']",3,11,10,12,weapons,0
Hiroshima and Nagasaki I remember all those killed in alleged US war crimes using nuclear weapons https://t.co/NDxrK2NCLN #USWarCrimes,21,"['remember', 'killed', 'using']",3,16,15,5,weapons,0
"Aug 3 1915├½Ôûê├ïKILL 10000 WITH ROCKS.; Italians Make Good Use of Nature's Weapons -- Excel with Bayonet.
http://t.co/ck1mMvHU0T",24,['Make'],1,1,0,23,weapons,0
Ukraine argues for US weapons during Pelosi's visit to Kiev http://t.co/jnN0kRNXvY http://t.co/5LOiWuyv5r,17,['argues'],1,5,4,12,weapons,0
@eyecuts @Erasuterism I love 96 Gal Deco to death even if it's a bit trickier to be great with. Glad more weapons are getting Splash Wall,30,"['@', 'love', ""'s"", 'be', 'are', 'getting']",6,26,25,4,weapons,0
#Battlefield 1942 forgotten hope secret weapons,7,['forgotten'],1,7,6,0,weapons,0
WWII Memories Plus Lessons of Hiroshima We Still Need Nuclear Weapons http://t.co/xbMm7ITe9q #denver #billings #rapidcity #seattle #cheyenne,24,['Need'],1,1,0,23,weapons,0
NAVY SAYS LT CMDR WHO FIRED SIDEARM IN DEFENSE DURING NOSC CHATTANOOGA TERRORIST ATTACK WILL NOT FACE CHARGES... http://t.co/vCcDKC4qt2,22,['weapons'],1,1,0,21,weapons,0
PM Abe pledged to make every effort to seek a world without nuclear weapons. http://t.co/CBXnHhZ6kD,18,"['pledged', 'make', 'seek']",3,14,13,4,weapons,0
I will adamantly opposed to nuclear weapons.,8,['opposed'],1,7,6,1,weapons,0
WWII Memories Plus Lessons of Hiroshima We Still Need Nuclear Weapons http://t.co/MTgFx3efIv #denver #billings #rapidcity #seattle #cheyenne,24,['Need'],1,1,0,23,weapons,0
"Navy: No charges against officer for weapons violations in Chattanooga attack
 http://t.co/hddBMU2ycA",15,['weapons'],1,8,7,7,weapons,0
'The Reagan Administration had arranged for Israeli weapons to be sent to the Guatemalan Army  http://t.co/4fYNQ1hWWb,18,"['had', 'arranged', 'be', 'sent']",4,8,7,10,weapons,0
In memory of the victims of Hiroshima and Nagasaki. Never again! Ban nuclear weapons! : https://t.co/J3cIRXjFa6,21,['weapons'],1,16,15,5,weapons,0
A quarter whirlwind. They don't see it coming.,11,"['do', 'see', 'coming']",3,3,2,8,whirlwind,0
Missing Malaysian airplane: Debris was planted ├½Ôûê├è Families News - WhirlWind News http://t.co/bLd0nHKzbh,16,"['Missing', 'was', 'planted']",3,1,0,15,whirlwind,0
Weather forecast for Thailand  A Whirlwind is coming ...2 september https://t.co/rUKjYjG9oQ,14,"['is', 'coming']",2,1,0,13,whirlwind,1
"life can wild when... 
you're caught in a whirlwind ??",13,"['wild', ""'re"", 'caught']",3,11,10,2,whirlwind,0
Warcraft has always been this weird referential whirlwind to itself and other things,13,"['has', 'been']",2,8,7,5,whirlwind,0
Back from Seattle Tacoma and Portland. Whirlwind! http://t.co/qwHINBni8e,12,['whirlwind'],1,1,0,11,whirlwind,0
I moved to England five years ago today. What a whirlwind of time it has been! http://t.co/eaSlGeA1B7,21,"['moved', 'has', 'been']",3,12,11,9,whirlwind,0
Whirlwind Medusa Audio Snake: 16 microphone inputs 0 returns 150 ft http://t.co/mxkAlMQpdb http://t.co/8KZnhtYtt9,18,['whirlwind'],1,1,0,17,whirlwind,0
@byuwnbeki The sad eyes and tacit stories in your heart that night in which the whirlwind was raging,19,"['byuwnbeki', 'was', 'raging']",3,17,16,2,whirlwind,0
Whirlwind that has lasted for more than an hour and still strong. A standstill in parts of middle east.,21,"['has', 'lasted']",2,1,0,20,whirlwind,1
Two hours to get to a client meeting. Whirlwind of emotions with this #tubestrike,16,['get'],1,1,0,15,whirlwind,0
Feel like I've got no control of anything that goes on in my life at the minute. #whirlwind #drained,23,"[""'ve"", 'got', 'goes', 'drained']",4,21,20,2,whirlwind,0
Richard returns after whirlwind few days http://t.co/L8W30WFW3R #MLB,11,['whirlwind'],1,4,3,7,whirlwind,0
@ckosova Read Whirlwind about this subject amongst others. The bomb saved millions of lives yes that's true.,21,"['saved', 'yes', ""'s""]",3,1,0,20,whirlwind,0
This past week has been an absolute whirlwind.... Athens bound,12,"['has', 'been']",2,8,7,4,whirlwind,0
WIN: Lisowski whitewashes the Whirlwind 5-0 in round 2 of Shanghai Masters Quals! |  http://t.co/MLigPUHVOh #snooker http://t.co/TcS2Cd5y6y,24,['whitewashes'],1,1,0,23,whirlwind,0
#HarperANetflixShow  Blazing Saddles  (a show about wild fires in Alberta),13,['wild fires'],1,1,0,12,wild fires,0
As wild fires blacken northern California parched Harris County becomes tinder box.  https://t.co/i2lwTy5YuP,16,"['blacken', 'parched', 'becomes']",3,1,0,15,wild fires,0
?? #BREAKING: massive wild- and field fires reported throughout Germany! The most fires are in eastern #German http://t.co/4zSIy7EO2O,25,"['reported', 'are']",2,1,0,24,wild fires,1
We all complain about PA but atleast we don't have those wild fires taking our homes like north Cali or the floods in Florida right now,27,"['complain', 'do', 'have', 'taking']",4,1,0,26,wild fires,0
Collection of Articals and Video of West Coast Wild Fires by @ABC http://t.co/qd3DSSFWUE,16,['wild fires'],1,1,0,15,wild fires,0
my wife has opted to take holidays &amp; historically since we met @lanahillman gets special treatment her bonfires can't start wild fires-RAIN!,27,"['has', 'opted', 'take', 'met', 'gets', 'start']",6,1,0,26,wild fires,0
My brother-n-law riooooos got the call to head up north and fight the wild fires. Dudes a beast at├½Ôûê_ https://t.co/463P0yS0Eb,23,"['got', 'head', 'fight', 'Dudes']",4,1,0,22,wild fires,0
Several wild fires have burned a lot of land in California. Here is one of the larger fires. http://t.co/2M1gNeaiFl http://t.co/UQh85MiP0v,26,"['have', 'burned', 'is']",3,1,0,25,wild fires,1
Map shows where all of California's wild#fires are burning: This map created by CAL FIRE├½Ôûê_ http://t.co/0x8jAQToWM http://t.co/m1RoSi2Wcs,25,"['are', 'burning', 'created']",3,1,0,24,wild fires,1
Some great footage of STRONG work from San Bernardino County Fire who is also working the wild fires right now.... http://t.co/QCYQHvn2Ha,25,"['is', 'working']",2,1,0,24,wild fires,0
God forbid this is true #California has enough problems with severe #drought &amp; #wild fires. http://t.co/CMsgexM4FC #Nuclear Power #SanOnofre,29,"['is', 'has']",2,1,0,28,wild fires,0
NetNewsLedger Wild Fire Update ├½Ôûê├è August 4 2015: THUNDER BAY ├½Ôûê├è WEATHER ├½Ôûê├è There├òÔò®were no new fires confirmed by t... http://t.co/JflxgEmBdA,25,['confirmed'],1,1,0,24,wild fires,0
Firefighters Headed To California To Fight Wild Fires http://t.co/J2PYkYo0EN,11,['Headed'],1,1,0,10,wild fires,0
#FOXDebateQuestions:  To what degree has Obama's efforts to institute Sharia Law exacerbated the California wild fires?,20,"['has', 'institute', 'exacerbated']",3,1,0,19,wild fires,0
PRAYERS FOR MY COUSIN! He's in California helping with the wild fires.,15,"[""'s"", 'helping']",2,1,0,14,wild fires,0
Catastrophic wild fires threatening U.S. Mid west &amp; Republicans fighting new climate change rules I guess this is the ultimate in Darwinism,25,"['threatening', 'fighting', 'guess', 'is']",4,1,0,24,wild fires,0
@myralynn24 Becuase it can cause property damage and cause wild fires,12,['cause'],1,1,0,11,wild fires,0
Hey @Macys ! My moms house burned down in the CA wild fires &amp; I bought her an e gift card to buy her CLOTHES (cont) http://t.co/sWdjnypCXK,34,"['burned', 'bought', 'buy']",3,1,0,33,wild fires,0
California wild fires...clearly caused by global climate change and excess CO2!!!?,17,['caused'],1,1,0,16,wild fires,0
@Jennife29916207 I was thinking about you today when I was reading about the wild fires,16,"['was', 'thinking', 'was', 'reading']",4,1,0,15,wild fires,0
@cnni @PrisonPlanet Climate Change CNN weather 'specialist' warning:wild fires rain flooding noting about the sun? http://t.co/0sZwlWL9qU,24,"['rain', 'flooding', 'noting']",3,1,0,23,wild fires,0
@SenFeinstein   Thanks Sen. Feinstein now hurry home because California is a huge uncontrolled wild fire. Lightening is starting new fires.,23,"['hurry', 'is', 'is', 'starting']",4,1,0,22,wild fires,1
Wild fires freak me the fuck out. Like hell no,11,['freak'],1,1,0,10,wild fires,0
California wild fires blow my mind every time,8,['blow'],1,1,0,7,wild fires,0
@MrRat395 Are those wild fires getting anywhere near you?,11,['getting'],1,1,0,10,wild fires,0
Man! What I would give to be in CA right now to help with the wild fires.,19,"['give', 'be', 'help']",3,1,0,18,wild fires,0
In Europe nature is kind while in US they have tornados hurricanes wild fires earthquakes flash floods mega snow droughts.,21,"['is', 'have', 'tornados', 'earthquakes', 'mega']",5,1,0,20,wild fires,0
Go home California you're drunk. Natural selection has taken affect. Debt extreme wild fires water supply problems. You fail as a state.,27,"[""'re"", 'has', 'taken', 'fail']",4,1,0,26,wild fires,0
Firefighters from Connecticut are headed to California to fight wild fires http://t.co/QWpUxPyWbF http://t.co/8jlXZ6fkxy,17,"['are', 'headed', 'fight']",3,1,0,16,wild fires,1
These wild fires out west are crazy.,8,['are'],1,1,0,7,wild fires,1
DEEP crew to help with California wild fires http://t.co/QKz2Sp06xn via @thedayct,14,['help'],1,1,0,13,wild fires,1
@CBS evening news covers tent collapse wild fires NO mention of worst Planned Parenthood video to date #Narrative,20,"['covers', 'fires', 'Planned']",3,1,0,19,wild fires,0
@aria_ahrary @TheTawniest The out of control wild fires in California even in the Northern part of the state. Very troubling.,24,['wild fires'],1,1,0,23,wild fires,1
Full Episode:  WN 08/02/15: California Wild Fires Force 12000 to Evacuate #Worldnews http://t.co/9ikhdyHVnC,18,['wild fires'],1,1,0,17,wild fires,1
@randerson62 Watching news of wild fires and hope all is ok.,13,"['hope', 'is']",2,1,0,12,wild fires,0
WILD FIRES! http://t.co/EgrMdkXpOi,6,['wild fires'],1,1,0,5,wild fires,0
Wild Fires In California Continue To Burn - http://t.co/nKcmib9WL0 http://t.co/CpMGBWVDXM,14,['wild fires'],1,1,0,13,wild fires,1
one of them wild fires in cali or something or in the mid west or where ever they show up..shit dont pop up around me,25,"['show', 'pop']",2,1,0,24,wild fires,0
@JacobHoggard @therealmattleaf  it's so sad out there in BC all the wild fires. Hope u are safe.,22,"['therealmattleaf', ""'s"", 'are']",3,1,0,21,wild fires,0
@EnzasBargains A5 Donated some fruit snacks &amp; handi wipes to our fire fighters battling wild fires! #ProfitToThePeople,22,"['Donated', 'battling']",2,1,0,21,wild fires,0
when there's 35 wild fires in the US and 21 of them are in California....AND we're in a drought.....this state is so sad,29,"[""'s"", 'are', ""'re"", 'is']",4,1,0,28,wild fires,0
Wild land fires.. Here I come. ??????,13,['come'],1,1,0,12,wild fires,0
My heart goes out to all those effected by the wild fires in Cali????,18,"['goes', 'effected']",2,1,0,17,wild fires,0
Wild fires in California... Must be Global Warming. Can't just be extreme heat combined with dry foliage ignited by some douchebag hiker.,26,"['be', 'be', 'combined', 'ignited']",4,1,0,25,wild fires,0
Does the #FingerRockFire make you wonder 'am I prepared for a wildfire'. Find out at http://t.co/eX8A5JYZm5 #azwx http://t.co/DeEeKobmXa,26,"['Does', 'make', 'wonder', 'prepared', 'Find']",5,13,12,13,wildfire,0
"kc5kH mhtw4fnet

Crews gaining on huge Northern California wildfire - CBS News",12,['wildfire'],1,9,8,3,wildfire,0
Fire in Pisgah National Forest grows to 375 acres - WSOC Charlotte http://t.co/djUfkRrtFt,15,['grows'],1,1,0,14,wildfire,1
Route Complex AM Fire Update (Route Complex Wildfire): FIRE UPDATE: ROUTE COMPLEX Thursday Morning Aug... http://t.co/nS5lBS5ZUp #CAFire,25,['wildfire'],1,1,0,24,wildfire,1
Parker Ridge Fact Sheet Aug 6 2015 (Parker Ridge Wildfire): Information Phone: 208-267-6773 Email: pa... http://t.co/ezEIsaSm0C #IDFire,26,['wildfire'],1,1,0,25,wildfire,1
'Some hearths they burn like a wildfire' https://t.co/of3td6DGLb by Bees Knees,14,['burn'],1,7,6,7,wildfire,0
Finger Rock wildfire grows to 500 acres #Tucson http://t.co/zSXGEI1Nxf,12,['grows'],1,3,2,9,wildfire,1
#chattanooga The Latest: California governor headed to site of wildfire http://t.co/D6E7IICW5W,15,"['chattanooga', 'headed']",2,12,11,3,wildfire,0
Here's a quick timelapse I made of the Finger Rock Fire last night from about 9PM - 1AM. Check it out! #fingerrockfire #wildfire #catalinas,30,"[""'s"", 'made', 'Check']",3,28,27,2,wildfire,0
Drones Under Fire: Officials Offer $75000 Reward Leading To Pilots Who Flew Over Wildfire http://t.co/d2vEppeh8S #photography #arts,23,"['Offer', 'Leading']",2,1,0,22,wildfire,0
Be ember aware! http://t.co/LZmL1xB2nH,7,['wildfire'],1,1,0,6,wildfire,0
California wildfire destroys more homes but crews advance http://t.co/7XQ8JrtL7I Free tool online http://t.co/J90dT2qnXb,17,['destroys'],1,2,1,15,wildfire,0
#WAwildfire in #chelan? Wolverine fire results in evacuation. http://t.co/yePlnZPoWu,15,['wildfire'],1,1,0,14,wildfire,0
#IDFire Parker Ridge Fact Sheet Aug 6 2015 (Parker Ridge Wildfire): Information Phone: 208-267-6773 Email: pa... http://t.co/ZggpaCjP7D,26,['wildfire'],1,1,0,25,wildfire,0
Is LA at Risk for a Giant Wildfire? - Which Way L.A.? on KCRW http://t.co/6AgMkx2WW4,19,['Is'],1,1,0,18,wildfire,1
California is battling its scariest 2015 wildfire so far. http://t.co/Lec1vmS7x2,13,"['is', 'battling']",2,7,6,6,wildfire,0
Wildfire Burns On California U.s. China Economic Net ├½Ôûê_ : http://t.co/U2dO2mC2ri  http://t.co/3oM3xw6CZ8,16,['wildfire'],1,1,0,15,wildfire,0
Cherokee Road and Road 22 (Three Sisters Wildfire): There are two roads closed to the general public: ... http://t.co/WwnL8FvfMM #IDFire,27,"['are', 'closed']",2,1,0,26,wildfire,1
Dr. Bengston on #wildfire management: ├½Ôûê┬ñnumbers and size of fires areas affected and costs of fighting them all show upward trend.├½Ôûê├ÿ #smem,25,"['affected', 'fighting', 'show']",3,5,4,20,wildfire,0
As California fires rage the Forest Service sounds the alarm about sharply rising wildfire costs http://t.co/ht8FyiMJlR,18,"['fires', 'rage', 'sounds', 'rising', 'http']",5,14,13,4,wildfire,0
The Latest: Washington #Wildfire misses town; evacuations end - KHQ Right Now http://t.co/aNlhW2IzkZ,18,"['misses', 'end', 'http']",3,1,0,17,wildfire,1
"Wolverine Fire Update - Thursday August 6 - 9:00 Am

Incident: Wolverine Fire Wildfire
Released: 41 min. ago... http://t.co/8WDTTzpTXH",25,['Released'],1,1,0,24,wildfire,1
Cooler weather helps crews battling state wildfire.. Related Articles: http://t.co/15fHVIi9Qp,13,"['helps', 'crews', 'battling']",3,7,6,6,wildfire,0
PHOTOS: The Rocky Fire has grown into California's most destructive wildfire this year. http://t.co/h9v4HoWtiP http://t.co/8IcSesHbj3,22,"['has', 'grown']",2,13,12,9,wildfire,1
Wildfire near Columbia River town is 50 percent contained http://t.co/gzGpWSqyMW #FireNews #WA http://t.co/ay49MTYyL8,19,"['is', 'contained']",2,1,0,18,wildfire,0
! Residents Return To Destroyed Homes As Washington Wildfire Burns on http://t.co/UcI8stQUg1,14,['Return'],1,1,0,13,wildfire,0
California is battling its scariest 2015 wildfire so far - the Rocky Fire http://t.co/sPT54KfA9Q,16,"['is', 'battling']",2,7,6,9,wildfire,0
Solitude Fire Update August 6 2015 (Solitude Wildfire): Summary: This lightning-caused fire is being ... http://t.co/4eSbsA8InT #UTFire,24,"['is', 'being']",2,1,0,23,wildfire,0
The Latest: More homes razed by Northern California wildfire - LancasterOnline http://t.co/ph7wllKRfI #Lancaster,17,['razed'],1,10,9,7,wildfire,1
Reuters Top News: PHOTOS: The Rocky Fire has grown into California's most ... - http://t.co/qwrRfDGXCc #NewsInTweets http://t.co/sstj2bEpqn,25,"['has', 'grown', 'http']",3,1,0,24,wildfire,0
This machine really captured my attention. #helicopter #firefighting #wildfire #oregon #easternoregon├½Ôûê_ https://t.co/V6qxnFHRxF,20,"['captured', 'firefighting']",2,13,12,7,wildfire,0
For those impacted by the #CalWildfires here are some great recovery tips to help you in the aftermath http://t.co/wwxbGuBww5,22,"['impacted', 'are', 'help']",3,1,0,21,wildfire,0
#IDFire Cherokee Road and Road 22 (Three Sisters Wildfire): There are two roads closed to the general public: ... http://t.co/UORXfF0NfX,27,"['are', 'closed']",2,1,0,26,wildfire,1
Wildfire near Columbia River town is 50 percent contained - http://t.co/yTPiPXpqr9 http://t.co/HCUQ6jpBtL,16,"['is', 'contained']",2,1,0,15,wildfire,1
Oregon's biggest wildfire slows growth http://t.co/P0GoS5URXG via @katunews,12,['slows'],1,4,3,8,wildfire,0
"smHRN mhtw4fnet

Crews gaining on huge Northern California wildfire - CBS News",12,['wildfire'],1,9,8,3,wildfire,0
Media Release - Firefighters Ask Hikers to Sign-in at Local Trailheads (Parker Ridge Wildfire): Parker... http://t.co/ABlz20mgzv #IDFire,24,['Ask'],1,1,0,23,wildfire,0
Rocky Fire #cali #SCFD #wildfire #LakeCounty https://t.co/3pu0000v5o,13,['wildfire'],1,8,7,5,wildfire,0
This machine really captured my attention. #helicopter #firefighting #wildfire #oregon #easternoregon├½Ôûê_ https://t.co/eKt456jY1s,20,"['captured', 'firefighting']",2,13,12,7,wildfire,0
Forest Grove grass fire sparked by tractor quickly contained - KATU http://t.co/FMbcocS79u,14,"['sparked', 'contained']",2,1,0,13,wildfire,1
The Latest: #Wildfire destroys more homes but crews advance - WQOW TV News 18 http://t.co/Hj26SFDdfI,19,['destroys'],1,1,0,18,wildfire,0
#California #wildfire destroys more homes but crews advance. http://t.co/2PPzGpxybi http://t.co/dS9khKffwc,17,['destroys'],1,4,3,13,wildfire,0
Windstorm lastingness perquisite - acquiesce in a twister retreat: ZiUW http://t.co/iRt4kkgsJx,14,['windstorm'],1,1,0,13,windstorm,0
IJ: Texas Seeks Comment on Rules for Changes to Windstorm Insurer http://t.co/h132iuL7MU,15,['Windstorm'],1,1,0,14,windstorm,0
*looks outside at the windstorm* niiiice,6,['windstorm'],1,5,4,1,windstorm,0
Texas Seeks Comment on Rules for Changes to Windstorm├òÔò®Insurer http://t.co/92fwtObi3U,12,['windstorm'],1,1,0,11,windstorm,0
NEMA Ekiti distributed relief materials to affected victims of Rain/Windstorm disaster at Ode-Ekiti in Gbonyin LGA.,17,['distributed'],1,1,0,16,windstorm,0
Reality Training: Train falls off elevated tracks during windstorm http://t.co/etgQf28MgE,13,['falls'],1,10,9,3,windstorm,1
#Insurance Texas Seeks Comment on Rules for Changes to Windstorm Insurer: The Texas Department of Insurance is...  http://t.co/byvUBg0WyE,23,"['Windstorm', 'is']",2,1,0,22,windstorm,0
Reality Training: Train falls off elevated tracks during windstorm http://t.co/wAL4FrTfKa #fire #ems,17,['falls'],1,10,9,7,windstorm,1
Reality Training: Train falls off elevated tracks during windstorm http://t.co/qzRciNaF5z,13,['falls'],1,10,9,3,windstorm,1
My precious olive tree lost this battle...another crazy windstorm in #yyc! @weathernetwork http://t.co/N00DVXEga2,20,['lost'],1,11,10,9,windstorm,0
NW Michigan #WindStorm (Sheer) Recovery Updates: Leelanau &amp; Grand Traverse - State of Emergency 2b extended http://t.co/OSKfyj8CK7 #BeSafe,27,"['Updates', 'extended']",2,1,0,26,windstorm,0
Damn...was wondering where my drone ended up after the freak windstorm...?? https://t.co/dHgGxo7Mcc,19,"['was', 'wondering', 'ended']",3,13,12,6,windstorm,0
@blakeshelton DON'T be a FART ??in a WINDSTORM.FOLLOW ME ALREADY. JEEZ.,17,"['DO', 'be']",2,1,0,16,windstorm,0
A few more photos from this mornings windstorm. We've never seen anything like it! #rhodeisland #warwick,21,"[""'ve"", 'seen']",2,8,7,13,windstorm,0
@rangerkaitimay had major windstorm thunder and some rain down here near Jackson...calm now.,17,"['had', 'rain']",2,5,4,12,windstorm,0
TWIA board approves 5 percent rate hike: The Texas Windstorm Insurance Association (TWIA) Board of Directors v... http://t.co/TWPl0NL8cx,24,"['approves', 'v']",2,1,0,23,windstorm,0
Gunmen kill four in El Salvador bus attack: Suspected Salvadoran gang members killed four people and wounded s... http://t.co/r8k6rXw6D6,23,"['kill', 'Suspected', 'killed', 'wounded']",4,18,17,5,wounded,1
Police Officer Wounded Suspect Dead After Exchanging Shots http://t.co/e4wvXQItV4,11,"['Wounded', 'Exchanging']",2,1,0,10,wounded,1
Police Officer Wounded Suspect Dead After Exchanging Shots http://t.co/XxFk4KHbIw,11,"['Wounded', 'Exchanging']",2,1,0,10,wounded,1
Gunmen open fire on bus near El Salvador's capital killing 4 a week after gang attacks killed 8 bus drivers: http://t.co/Pz56zJSsfT bit├½Ôûê_,26,"['killing', 'killed']",2,1,0,25,wounded,1
Officer Wounded Suspect Killed in Exchange of Gunfire: Richmond police officer wounded suspect killed in exc... http://t.co/crCN8rwvKj,21,"['Wounded', 'wounded', 'killed']",3,13,12,8,wounded,1
One man fatally shot another wounded on Vermont Street #Buffalo - http://t.co/KakY4mpCO4,15,"['shot', 'wounded']",2,6,5,9,wounded,1
Richmond police officer wounded suspect killed http://t.co/m9d2ElImZI,9,"['wounded', 'killed']",2,4,3,5,wounded,1
"The South Korean army wounded 44 persons' Takeshima's Japanese fisherman and occupies the island.  
http://t.co/mJCXgKU8Yt",20,"['wounded', 'occupies']",2,5,4,15,wounded,1
Gunmen kill four in El Salvador bus attack: Suspected Salvadoran gang members killed four people and wounded s... http://t.co/LZWRONbTmi,23,"['kill', 'Suspected', 'killed', 'wounded']",4,18,17,5,wounded,1
You still acting like you were the one wounded. Didn't you do the stabbing?...,18,"['acting', 'were', 'wounded', 'Did', 'do']",5,9,8,9,wounded,0
"Prince Phillip said of the numbers of those murdered by the British at Amritsar...

├½Ôûê┬ñThat├½Ôûê┬¼s a bit exaggerated it must include the wounded├½Ôûê├ÿ.",25,"['said', 'murdered', '├½Ôûê┬ñThat├½Ôûê┬¼s', 'include']",4,24,23,1,wounded,0
California cops have sketch of gunman who killed one wounded two deputies via the @FoxNews app http://t.co/3Ife1zsop7,20,"['have', 'killed', 'wounded', 'app']",4,10,9,10,wounded,0
Police Officer Wounded Suspect Dead After Exchanging Shots: Richmond police officer wounded suspect killed after exchange of gunfire,19,"['Wounded', 'Exchanging', 'wounded', 'killed']",4,13,12,6,wounded,0
Let's not forget our wounded female veterans. http://t.co/rZ7fbr10xw,12,"['Let', 'forget']",2,6,5,6,wounded,0
#Dime_Miloko Officer Wounded Suspect Killed in Exchange of Gunfire: Richmond police officer wounded suspect killed in exchange of gunfire,21,"['Wounded', 'wounded', 'killed']",3,15,14,6,wounded,0
Gunmen kill four in El Salvador bus attack: Suspected Salvadoran gang members killed four people and wounded s... http://t.co/CNtwB6ScZj,23,"['kill', 'Suspected', 'killed', 'wounded']",4,18,17,5,wounded,0
Police officer wounded suspect dead after exchanging shots: A Richmond police officer was wounded and a suspe... http://t.co/FzQPiQeCHB,22,"['wounded', 'exchanging', 'was', 'wounded']",4,15,14,7,wounded,0
One man fatally shot another wounded on Vermont Street #Buffalo - http://t.co/8ACDF4Zui6,15,"['shot', 'wounded']",2,6,5,9,wounded,0
Police officer wounded suspect dead after exchanging shots: RICHMOND Va. (AP) ├½Ôûê├ï A Richmond police officer wa... http://t.co/Y0qQS2L7bS,24,"['wounded', 'exchanging', '├½Ôûê├ï']",3,3,2,21,wounded,0
Police Officer Wounded Suspect Dead After Exchanging Shots - http://t.co/iPHaZV47g7,12,"['Wounded', 'Exchanging']",2,1,0,11,wounded,1
Police Officer Wounded Suspect Dead After Exchanging Shots http://t.co/brE2lGmn7C #ABC #News #AN247,17,"['Wounded', 'Exchanging']",2,1,0,16,wounded,1
@wocowae Police Officer Wounded Suspect Dead After Exchanging Shots http://t.co/oiOeCbsh1f ushed,14,"['Wounded', 'Exchanging', 'ushed']",3,1,0,13,wounded,1
The Police Chief assured the crowd that this officer-related shooting would be investigated: http://t.co/KMXzhO5TFM. http://t.co/AlBvDNwJtg,21,"['assured', 'be', 'investigated']",3,1,0,20,wounded,0
Man seriously wounded in Auburn Gresham shooting http://t.co/qPsSbAfSuL #Chiraq,12,"['wounded', 'shooting']",2,3,2,9,wounded,1
Suspected Salvadoran gang members killed four people and wounded seven more on Wednesday in an attack on a bus as it travelled down a rural├½Ôûê_,25,"['Suspected', 'killed', 'wounded', 'travelled']",4,9,8,16,wounded,1
Police Officer Wounded Suspect Dead After Exchanging Shots: Richmond police officer wounded suspect killed a... http://t.co/5uFTRXPpV0,20,"['Wounded', 'Exchanging', 'wounded', 'killed']",4,13,12,7,wounded,1
Officer Wounded Suspect Killed in Exchange of Gunfire: Richmond police officer wounded suspect killed in exc... http://t.co/zDHwRN6cZc,21,"['Wounded', 'wounded', 'killed']",3,13,12,8,wounded,1
Police Officer Wounded Suspect Dead After Exchanging Shots,8,"['Wounded', 'Exchanging']",2,1,0,7,wounded,1
Officer Wounded Suspect Killed in Exchange of Gunfire http://t.co/HHSjnAVHUA,11,['Wounded'],1,1,0,10,wounded,1
Officer wounded suspect killed in exchange of gunfire: Richmond police say an officer has been wounded and a ... http://t.co/HwOrB1N6vN,23,"['wounded', 'killed', 'say', 'has', 'been', 'wounded']",6,17,16,6,wounded,1
.@wwp is serving more than 75k veterans. 52k OIF/OEF vets have physical wounds; many more have invisible ones http://t.co/sHHLV4dPlz #client,27,"['is', 'serving', 'have', 'have']",4,1,0,26,wounded,0
[#Latestnews] Police officer wounded suspect dead after exchanging shots: RICHMOND Va. (AP) ├½Ôûê├ï A Richmond pol... http://t.co/ia1HnGnHVB,26,"['wounded', 'exchanging', '├½Ôûê├ï']",3,7,6,19,wounded,0
ABC News: Police Officer Wounded Suspect Dead After Exchanging Shots. More #news - http://t.co/AzovGv4SB6,19,"['Wounded', 'Exchanging']",2,1,0,18,wounded,1
@wocowae Officer Wounded Suspect Killed in Exchange of Gunfire http://t.co/QI2BDvkab7 ushed,14,['ushed'],1,1,0,13,wounded,1
Police Officer Wounded Suspect Dead After Exchanging Shots: Richmond police officer wounded suspect killed a... http://t.co/w0r8EAOKA0,20,"['Wounded', 'Exchanging', 'wounded', 'killed']",4,13,12,7,wounded,1
'Police Officer Wounded Suspect Dead After Exchanging Shots' http://t.co/guNq7ZTUn4 #????_?????,23,"['Exchanging', '_']",2,1,0,22,wounded,1
Police Officer Wounded Suspect Dead After Exchanging Shots: Richmond police officer wounded suspect killed a... http://t.co/YIKQRqczVZ,20,"['Wounded', 'Exchanging', 'wounded', 'killed']",4,13,12,7,wounded,1
He was crushed for our iniquities; the punishment that brought us peace was upon him &amp; by his wounds we are healed. -Isa 53:5,28,"['was', 'crushed', 'brought', 'was', 'are', 'healed']",6,22,21,6,wounds,0
Gunshot wound #9 is in the bicep. The only one of the ten wounds that is not in the chest/torso area.  #KerrickTrial #JonathanFerrell,28,"['wound', 'is', 'is']",3,16,15,12,wounds,0
Read ~ THE UNHEALED WOUNDS OF AN UNENDING CONFLICT #Kashmir #Pakistan #India http://t.co/sAF9MoSkSN #EndOccupation #EndConflict #FreeKashmir,24,['~'],1,1,0,23,wounds,0
ME: gun shot wounds 3 4 6 7 'rapidly lethal' would have killed in 30-60 seconds or few minutes max. #kerricktrial,25,"['wounds', 'have', 'killed', 'max']",4,5,4,20,wounds,1
Acc to the study conducted by SKIMS morethan 50% population in #Kashmir suffer psychiatric disorders http://t.co/sAF9MoSkSN #KashmirConflict,22,"['conducted', 'morethan', 'suffer', 'http']",4,1,0,21,wounds,0
Israeli military shoot Palestinian who injured 3 in West Bank car attack http://t.co/P9DCnuLODR via @YahooNews,18,['injured'],1,1,0,17,wounds,1
Dr. Owen says four of Ferrell's ten bullet wounds were 'rapidly lethal' #KerrickTrial #TWCNewsCLT http://t.co/nNBEXhKlHr,21,"['says', 'were']",2,10,9,11,wounds,0
2 Policemen receive bullet wounds Reports indicate 6-7 armed men attacked a police post.,15,"['indicate', 'armed', 'attacked']",3,5,4,10,wounds,1
Palestinian rams car into Israeli soldiers wounding 3 http://t.co/n79BMXQKlg #EMM,13,['wounding'],1,1,0,12,wounds,1
Woodlawn Shooting Wounds 79-Year-Old Woman Teen - Woodlawn - http://t.co/nu3XXn55vS Chicago http://t.co/XNGrfNQSx3,16,['wounds'],1,1,0,15,wounds,1
@IcyMagistrate ├½Ôûê├ïher upper arm├½Ôûê├è those /friggin/ icicle projectiles├½Ôûê├è and leg from various other wounds the girl looks like a miniature more├½Ôûê├ï,22,['wounds'],1,15,14,7,wounds,0
Explosion in Gaza Strip kills four wounds 30; cause unknown http://t.co/GopSiCP8bm via @Reuters,17,['kills'],1,7,6,10,wounds,1
"Crawling in my skin
These wounds they will not hea",10,"['Crawling', 'hea']",2,6,5,4,wounds,0
Driver rams car into Israeli soldiers wounds 3: military: A driver rammed a car into a group of Israeli soldi... http://t.co/oBSZ45ybAJ,26,"['wounds', 'rammed']",2,7,6,19,wounds,1
Sorrower  - Fresh Wounds Over Old Scars  (2015 Death Metal) http://t.co/L056yj2IOi http://t.co/uTMWMjiRty,18,['wounds'],1,1,0,17,wounds,0
@Captainn_Morgan car wreck ??,6,['wreck'],1,4,3,2,wreck,0
Watertown Gazette owner charged in wreck http://t.co/JHc2RT0V9F,9,['charged'],1,6,5,3,wreck,0
Last week we had a blast hosting Dinner &amp; a Movie Night with 'Wreck-It Ralph' on @FtCarsonPAO! @carsonmwr #TBT http://t.co/tUYPxEoBQa,29,['had'],1,1,0,28,wreck,0
the sunset boys wreck my bed   original 1979 usa gimp label  vinyl 7' 45  newave http://t.co/X0QLgwoyMT http://t.co/hQNx8qMeG3,22,"['boys', 'wreck']",2,4,3,18,wreck,0
@GeorgeFoster72 and The Wreck of the Edmund Fitzgerald,9,['wreck'],1,1,0,8,wreck,0
Man faces manslaughter charges following fatal Sunday wreck | AL.c.. Related Articles: http://t.co/5xrFhdXTvX,16,"['faces', 'following']",2,8,7,8,wreck,0
Wreck with road blockage Woodward Avenue Northbound at Davison in M.S. #shoalstraffic,14,['wreck'],1,1,0,13,wreck,0
Greer man dies in wreck http://t.co/n2qZbMZuly,8,['dies'],1,5,4,3,wreck,1
Omg if Cain dies i will be an emotional wreck #emmerdale,12,"['dies', 'be']",2,10,9,2,wreck,0
Wreckage 'Conclusively Confirmed' as From MH370: Malaysia PM: Investigators and the families of those who were... http://t.co/SfAKQNveta,23,['were'],1,1,0,22,wreckage,1
Wreckage Confirmed As Part of Missing Malaysia Airlines Flight MH370 http://t.co/yoPeYPJkb2 (VICE News),17,['Confirmed'],1,1,0,16,wreckage,1
Wreckage 'Conclusively Confirmed' as From MH370: Malaysia PM: Investigators and the families of those who were... http://t.co/gRh7zLK979,23,['were'],1,1,0,22,wreckage,1
Wreckage 'Conclusively Confirmed' as From MH370: Malaysia PM,10,['wreckage'],1,1,0,9,wreckage,1
MH370 victim's family furious the media was told about wreckage confirmation first http://t.co/carMqiVkwU,16,"['furious', 'was', 'told', 'http']",4,11,10,5,wreckage,0
Wreckage 'Conclusively Confirmed' as From MH370: Malaysia PM: Investigators and the families of those who were... http://t.co/cUrJAT1BqI,23,['were'],1,1,0,22,wreckage,1
Wreckage 'Conclusively Confirmed' as From MH370: Malaysia PM: Investigators and the families of those who were... http://t.co/cs8mYAunA4,23,['were'],1,1,0,22,wreckage,1
Wreckage 'conclusively confirmed' as from MH370: Malaysia PM http://t.co/Se1QkNPltS | https://t.co/DnhRviV1dJ,17,['confirmed'],1,1,0,16,wreckage,1
#Australia #News ; RT janeenorman: 'High probability' aircraft wreckage is from #MH370 according to Deputy Prime ├½Ôûê_ http://t.co/cdOHgnJmsT,25,"['is', 'according']",2,13,12,12,wreckage,0
Wreckage 'Conclusively Confirmed' as From MH370: Malaysia PM: Investigators and the families of those who were... http://t.co/v5Ogr3F5N9,23,['were'],1,1,0,22,wreckage,1
Wreckage 'Conclusively Confirmed' as From MH370: Malaysia PM: Investigators and the families of those who were... http://t.co/4xB4ZwyhCt,23,['were'],1,1,0,22,wreckage,1
KUALA LUMPUR (Reuters) - A piece of a wing that washed up on an Indian Ocean island beach last week was part of the wreckage of Malaysian A,30,"['washed', 'was']",2,27,26,3,wreckage,0
#science Now that a piece of wreckage from flight MH370 has been confirmed on RÔòá┬«union Island is it possible t...  http://t.co/uqva3dfbCA,27,"['has', 'been', 'confirmed', 'is']",4,8,7,19,wreckage,1
Malaysia PM confirms wreckage belongs to MH370 http://t.co/kacrlpjC0l http://t.co/YjJbNTcaZY,13,['confirms'],1,4,3,9,wreckage,11
Wreckage 'Conclusively Confirmed' as From MH370: Malaysia PM: Investigators and the families of those who were... http://t.co/KfzvMXj9ST,23,['were'],1,1,0,22,wreckage,1
Wreckage 'Conclusively Confirmed' as From MH370: Malaysia PM: Investigators and the families of those who were... http://t.co/pTeVY815mt,23,['were'],1,1,0,22,wreckage,1
CIA plot! *rolling eyes* RT @ajabrown: Chinese relatives of MH370 victims say reunion island wreckage was planted http://t.co/wmNb5ITa5P,23,"['*rolling', 'say', 'was', 'planted']",4,18,17,5,wreckage,0
Wreckage 'Conclusively Confirmed' as From MH370: Malaysia PM: Investigators and the families of those who were... http://t.co/4sf0rgn8Wo,23,['were'],1,1,0,22,wreckage,1
Wreckage 'Conclusively Confirmed' as From MH370: Malaysia PM: Investigators and the families of those who were... http://t.co/leDmVEZCoL,23,['were'],1,1,0,22,wreckage,1
Wreckage 'Conclusively Confirmed' as From MH370: Malaysia PM,10,['wreckage'],1,1,0,9,wreckage,1
"Related News: 

Plane Wreckage Found Is Part Of Missing MH370 Malaysia Prime Minister?Says
 - World - BuzzFeed |  http://t.co/qSiPL1C9Fa",24,"['Related', '|']",2,1,0,23,wreckage,0
Wreckage 'Conclusively Confirmed' as From MH370: Malaysia PM: Investigators and the families of those who were... http://t.co/O8sTW4YN8R,23,['were'],1,1,0,22,wreckage,1
#science Now that a piece of wreckage from flight MH370 has been confirmed on RÔòá┬«union Island is it possible t...  http://t.co/cKQ7tOE82u,27,"['has', 'been', 'confirmed', 'is']",4,8,7,19,wreckage,0
Wreckage 'Conclusively Confirmed' as From MH370: Malaysia PM,10,['wreckage'],1,1,0,9,wreckage,1
Malaysian prime minister says Reunion Island wreckage is from MH370: http://t.co/bpTZAMjl2K via @slate,17,"['says', 'is']",2,7,6,10,wreckage,0
Wreckage 'Conclusively Confirmed' as From MH370: Malaysia PM: Investigators and the families of those who were... http://t.co/LjylxZ1fBi,23,['were'],1,1,0,22,wreckage,1
Wreckage 'Conclusively Confirmed' as From MH370: Malaysia PM: Investigators and the families of those who were... http://t.co/1RzskdRrDk,23,['were'],1,1,0,22,wreckage,1
TOP STORY: wreckage from #MH370 officially confirmed. @janisctv reports on the critical clue from a tiny island. http://t.co/hlWw2P5k9o,25,"['confirmed', '@']",2,4,3,21,wreckage,1
The first piece of wreckage from the first-ever lost Boeing 777 which vanished back in early March along with the 239 people on board has,25,"['lost', 'vanished', 'has']",3,5,4,20,wreckage,0
Wreckage 'Conclusively Confirmed' as From MH370: Malaysia PM: Investigators and the families of those who were... http://t.co/VAZpG0ftmU,23,['were'],1,1,0,22,wreckage,0
#science Now that a piece of wreckage from flight MH370 has been confirmed on RÔòá┬«union Island is it possible t...  http://t.co/qNVXJ2pAlJ,27,"['has', 'been', 'confirmed', 'is']",4,8,7,19,wreckage,0
Wreckage 'Conclusively Confirmed' as From MH370: Malaysia PM: Investigators and the families of those who were... http://t.co/DtFSWNJZIL,23,['were'],1,1,0,22,wreckage,1
Wreckage 'Conclusively Confirmed' as From MH370: Malaysia PM: Investigators and the families of those who were... http://t.co/EdEKrmqTpQ,23,['were'],1,1,0,22,wreckage,1
"Wreckage is MH370: Najib
http://t.co/iidKC0jSBx #MH370 #najibrazak #MalaysiaAirlines",14,['is'],1,1,0,13,wreckage,0
Check out 'Malaysia Confirms Plane Wreckage Is From Flight MH370' at  http://t.co/UB3woZ2UT1,15,"['Check', 'Is']",2,1,0,14,wreckage,1
#science Now that a piece of wreckage from flight MH370 has been confirmed on RÔòá┬«union Island is it possible t...  http://t.co/Z2vDGIyOwf,27,"['has', 'been', 'confirmed', 'is']",4,8,7,19,wreckage,0
Wreckage 'Conclusively Confirmed' as From MH370: Malaysia PM,10,['wreckage'],1,1,0,9,wreckage,1
Wreckage 'Conclusively Confirmed' as From MH370: Malaysia PM: Investigators and the families of those who were... http://t.co/2Jr3Yo55dr,23,['were'],1,1,0,22,wreckage,1
Wreckage 'Conclusively Confirmed' as From MH370: Malaysia PM http://t.co/MN130C4e2D via @ndtv,16,['wreckage'],1,1,0,15,wreckage,1
Wreckage 'conclusively confirmed' as from MH370: Malaysia PM http://t.co/Rp2DxFKHDQ | https://t.co/akmIHLRIs1,17,['confirmed'],1,1,0,16,wreckage,1
Wreckage 'Conclusively Confirmed' as From MH370: Malaysia PM: Investigators and the families of those who were... http://t.co/KuKmAL605a,23,['were'],1,1,0,22,wreckage,1
Wreckage 'Conclusively Confirmed' as From MH370: Malaysia PM,10,['wreckage'],1,1,0,9,wreckage,1
Wreckage 'Conclusively Confirmed' as From MH370: Malaysia PM: Investigators and the families of those who were... http://t.co/yi54XRHQGB,23,['were'],1,1,0,22,wreckage,1
Wreckage 'Conclusively Confirmed' as From MH370: Malaysia PM: Investigators and the families of those who were... http://t.co/mzB0MKuUo7,23,['were'],1,1,0,22,wreckage,1
Wreckage 'Conclusively Confirmed' as From MH370: Malaysia PM: Investigators and the families of those who were... http://t.co/MSsq0sVnBM,23,['were'],1,1,0,22,wreckage,1
Wreckage 'Conclusively Confirmed' as From MH370: Malaysia PM: Investigators and the families of those who were... http://t.co/nn6Y0fD3l0,23,['were'],1,1,0,22,wreckage,1
RT @australian Debris found on an Indian Ocean island confirmed to be from flight #MH370. http://t.co/gY9MrSl6x2,21,"['found', 'confirmed', 'be']",3,1,0,20,wreckage,1
Wreckage 'Conclusively Confirmed' as From MH370: Malaysia PM: Investigators and the families of those who were... http://t.co/1YIxFG1Hdy,23,['were'],1,1,0,22,wreckage,1
Wreckage 'conclusively confirmed' as from missing flight MH370 via @YahooNewsDigest,12,"['confirmed', 'missing']",2,1,0,11,wreckage,1
Wreckage 'Conclusively Confirmed' as From MH370: Malaysia PM: Investigators and the families of those who were... http://t.co/5EBpYbFH4D,23,['were'],1,1,0,22,wreckage,1
Almost *wrecked* my van the other day because of this guy (yeah I brake &amp; also care for animals ~ get used to it)!  https://t.co/8ZaHavmtT6,32,"['brake', 'amp', 'get', 'used']",4,1,0,31,wrecked,1
"Israel wrecked my home. Now it wants my land. 
https://t.co/g0r3ZR1nQj",14,"['wrecked', 'wants']",2,2,1,12,wrecked,0
@yakubOObs think he deactivated because his notifications are aids after tesco wrecked him lol,15,"['think', 'deactivated', 'are', 'wrecked', 'lol']",5,13,12,2,wrecked,0
RT CNBC '3 words from Disney CEO Bob Iger wrecked Disney's stock says Jim Cramer: http://t.co/f0texKsqhL http://t.co/ilySLaTMgI',25,"['wrecked', 'says']",2,11,10,14,wrecked,0
"300K exotic car wrecked in train accident 
http://t.co/J49xEuj7Ps",10,['wrecked'],1,4,3,6,wrecked,1
@Kirafrog @mount_wario Did you get wrecked again?,10,"['get', 'wrecked']",2,8,7,2,wrecked,0
Pic of 16yr old PKK suicide bomber who detonated bomb in Turkey Army trench released http://t.co/aaWZXykLES http://t.co/RsMvgDxRiv,21,"['detonated', 'released']",2,1,0,20,thunderstorm,0
#Ebola #EbolaOutbreak Ebola Virus: Birmingham Ala. Firefighters Quarantined After Possible Exposure Officials Say http://t.co/tjpYlU9fOX,20,"['Quarantined', 'Say']",2,1,0,19,evacuation,0
Malaysian PM confirms debris is from missing flight MH370 http://t.co/pfAvW5QyqE,12,"['debris', 'is', 'missing']",3,1,0,11,oil spill,0
Calgary Police Flood Road Closures in Calgary. http://t.co/RLN09WKe9g,11,['bombed'],1,1,0,10,bombed,1
#Sismo DETECTADO #JapÔòá_n 15:41:07 Seismic intensity 0 Iwate Miyagi JST #?? http://t.co/gMoUl9zQ2Q,18,['violent storm'],1,1,0,17,violent storm,0
BREAKING: #ISIS claims responsibility for mosque attack in Saudi Arabia that killed 13 http://t.co/VZ640XOSwj http://t.co/m2HpnOAK8b,21,"['claims', 'killed']",2,1,0,20,wild fires,0
Omg earthquake,2,['volcano'],1,1,0,1,volcano,1
SEVERE WEATHER BULLETIN No. 5 FOR: TYPHOON ├½Ôûê┬ñ#HannaPH├½Ôûê├ÿ (SOUDELOR) TROPICAL CYCLONE: WARNING ISSUED AT 5:00 PM 06... http://t.co/tHhjJw51PE ├½Ôûê_,29,['collided'],1,1,0,28,collided,1
Officials: Alabama home quarantined over possible Ebola case - Washington Times,12,['quarantined'],1,1,0,11,hazardous,0
Heat wave warning aa? Ayyo dei. Just when I plan to visit friends after a year.,19,"['wave', 'warning', 'plan', 'visit']",4,19,18,0,,0
An IS group suicide bomber detonated an explosives-packed vest in a mosque inside a Saudi special forces headquarters killing 15 people.,22,"['detonated', 'killing']",2,22,21,0,,0
A gas thing just exploded and I heard screams and now the whole street smells of gas ... ??,20,"['exploded', 'heard']",2,20,19,0,,1
NWS: Flash Flood Warning Continued for Shelby County until 08:00 PM Wednesday. http://t.co/nZ7ACKRrJi #tnwx,19,[''],1,19,18,0,,0
RT @LivingSafely: #NWS issues Severe #Thunderstorm Warnings for parts of #AR #NC #OK. Expect more trauma cases: http://t.co/FWqfCKNCQW,28,[''],1,28,27,0,,0
#??? #?? #??? #??? MH370: Aircraft debris found on La Reunion is from missing Malaysia Airlines ... http://t.co/5B7qT2YxdA,32,"['found', 'is', 'missing']",3,32,31,0,,0
Father-of-three Lost Control of Car After Overtaking and Collided #BathAndNorthEastSomerset http://t.co/fa3FcnlN86,14,[''],1,14,13,0,,0
1.3 #Earthquake in 9Km Ssw Of Anza California #iPhone users download the Earthquake app for more information http://t.co/V3aZWOAmzK,22,['download'],1,22,21,0,,1
Evacuation order lifted for town of Roosevelt: http://t.co/EDyfo6E2PU http://t.co/M5KxLPKFA1,14,['lifted'],1,14,13,0,,1
See the 16yr old PKK suicide bomber who detonated bomb in Turkey Army trench released: Harun Ôòá├ôekdar ... http://t.co/hKuT5mSdtP @MsOreo_,24,"['See', 'detonated', 'released']",3,24,23,0,,0
To conference attendees! The blue line from the airport has DERAILED - please look into taking a taxi to the hotel! See you soon!,27,"['has', 'DERAILED', 'look', 'taking', 'See']",5,27,26,0,,1
The death toll in a #IS-suicide car bombing on a #YPG position in the Village of Rajman in the eastern province of Hasaka has risen to 9,29,"['has', 'risen']",2,29,28,0,,0
#breaking #LA Refugio oil spill may have been costlier bigger than projected http://t.co/5ueCmcv2Pk,17,"['breaking', 'have', 'been', 'projected']",4,17,16,0,,0
a siren just went off and it wasn't the Forney tornado warning ??,15,"['went', 'was', 'warning']",3,15,14,0,,1
Officials say a quarantine is in place at an Alabama home over a possible Ebola case after developing symptoms... http://t.co/rqKK15uhEY,23,"['say', 'is', 'developing']",3,23,22,0,,0
#WorldNews Fallen powerlines on G:link tram: UPDATE: FIRE crews have evacuated up to 30 passengers who were tr... http://t.co/EYSVvzA7Qm,27,"['have', 'evacuated', 'were']",3,27,26,0,,0
on the flip side I'm at Walmart and there is a bomb and everyone had to evacuate so stay tuned if I blow up or not,27,"[""'m"", 'is', 'had', 'evacuate', 'blow']",5,27,26,0,,1
Storm in RI worse than last hurricane. My city&amp;3others hardest hit. My yard looks like it was bombed. Around 20000K still without power,30,"['looks', 'was', 'bombed']",3,30,29,0,,1
Suicide bomber kills 15 in Saudi security site mosque - Reuters via World - Google News - Wall ... http://t.co/nF4IculOje,22,[''],1,22,21,0,,1
#stormchase Violent Record Breaking EF-5 El Reno Oklahoma Tornado Nearly Runs Over ... - http://t.co/3SICroAaNz http://t.co/I27Oa0HISp,21,[''],1,21,20,0,,0
Green Line derailment in Chicago http://t.co/UtbXLcBIuY,8,[''],1,8,7,0,,1
Two giant cranes holding a bridge collapse into nearby homes http://t.co/STfMbbZFB5,13,['holding'],1,13,12,0,,1
@aria_ahrary @TheTawniest The out of control wild fires in California even in the Northern part of the state. Very troubling.,24,[''],1,24,23,0,,0
M1.94 [01:04 UTC]?5km S of Volcano Hawaii. http://t.co/zDtoyd8EbJ,15,['['],1,15,14,0,,0
Police investigating after an e-bike collided with a car in Little Portugal. E-bike rider suffered serious non-life threatening injuries.,21,['suffered'],1,21,20,0,,0
The Latest: More Homes Razed by Northern California Wildfire - ABC News http://t.co/YmY4rSkQ3d,16,['Razed'],1,16,15,0,,0
MEG issues Hazardous Weather Outlook (HWO) http://t.co/3X6RBQJHn3,11,[''],1,11,10,0,,0
#CityofCalgary has activated its Municipal Emergency Plan. #yycstorm,11,"['has', 'activated']",2,11,10,0,,1
